dataset,train_path,test_path,nrow_test_data,len_same_id_in_source_code,len_same_id_in_dataset,ratio,tp,fp,tn,fn,positive,negative
ECLIPSE-2007,dataset/original//ECLIPSE-2007/eclipse/eclipse-2.0.csv,dataset/original//ECLIPSE-2007/eclipse/eclipse-2.1.csv,7888,2781,2038,0.25836714,1,42,1983,12,43,1995
ECLIPSE-2007,dataset/original//ECLIPSE-2007/eclipse/eclipse-2.1.csv,dataset/original//ECLIPSE-2007/eclipse/eclipse-3.0.csv,10593,2470,2039,0.192485604,2,59,1969,9,61,1978
IND-JLMIV+R-2020,dataset/original//IND-JLMIV+R-2020/ant-ivy/ant-ivy-1.4.1.csv,dataset/original//IND-JLMIV+R-2020/ant-ivy/ant-ivy-2.0.0.csv,352,16,0,0,0,0,0,0,0,0
IND-JLMIV+R-2020,dataset/original//IND-JLMIV+R-2020/ant-ivy/ant-ivy-2.0.0.csv,dataset/original//IND-JLMIV+R-2020/ant-ivy/ant-ivy-2.1.0.csv,357,528,293,0.820728291,16,4,271,2,20,273
IND-JLMIV+R-2020,dataset/original//IND-JLMIV+R-2020/ant-ivy/ant-ivy-2.1.0.csv,dataset/original//IND-JLMIV+R-2020/ant-ivy/ant-ivy-2.2.0.csv,363,474,280,0.771349862,9,0,271,0,9,271
IND-JLMIV+R-2020,dataset/original//IND-JLMIV+R-2020/ant-ivy/ant-ivy-2.2.0.csv,dataset/original//IND-JLMIV+R-2020/ant-ivy/ant-ivy-2.3.0.csv,451,508,285,0.631929047,1,1,283,0,2,283
IND-JLMIV+R-2020,dataset/original//IND-JLMIV+R-2020/ant-ivy/ant-ivy-2.3.0.csv,dataset/original//IND-JLMIV+R-2020/ant-ivy/ant-ivy-2.4.0.csv,474,505,299,0.630801688,1,2,296,0,3,296
IND-JLMIV+R-2020,dataset/original//IND-JLMIV+R-2020/archiva/archiva-1.0.csv,dataset/original//IND-JLMIV+R-2020/archiva/archiva-1.1.csv,449,395,0,0,0,0,0,0,0,0
IND-JLMIV+R-2020,dataset/original//IND-JLMIV+R-2020/archiva/archiva-1.1.csv,dataset/original//IND-JLMIV+R-2020/archiva/archiva-1.2.csv,433,297,200,0.461893764,4,0,196,0,4,196
IND-JLMIV+R-2020,dataset/original//IND-JLMIV+R-2020/archiva/archiva-1.2.csv,dataset/original//IND-JLMIV+R-2020/archiva/archiva-1.3.csv,434,585,368,0.847926267,4,4,360,0,8,360
IND-JLMIV+R-2020,dataset/original//IND-JLMIV+R-2020/archiva/archiva-1.3.csv,dataset/original//IND-JLMIV+R-2020/archiva/archiva-2.0.0.csv,420,6,5,0.011904762,0,0,5,0,0,5
IND-JLMIV+R-2020,dataset/original//IND-JLMIV+R-2020/archiva/archiva-2.0.0.csv,dataset/original//IND-JLMIV+R-2020/archiva/archiva-2.1.0.csv,419,370,193,0.460620525,1,0,192,0,1,192
IND-JLMIV+R-2020,dataset/original//IND-JLMIV+R-2020/archiva/archiva-2.1.0.csv,dataset/original//IND-JLMIV+R-2020/archiva/archiva-2.2.0.csv,418,601,337,0.806220096,0,0,337,0,0,337
IND-JLMIV+R-2020,dataset/original//IND-JLMIV+R-2020/calcite/calcite-1.0.0.csv,dataset/original//IND-JLMIV+R-2020/calcite/calcite-1.1.0.csv,1103,967,869,0.787851315,67,1,801,0,68,801
IND-JLMIV+R-2020,dataset/original//IND-JLMIV+R-2020/calcite/calcite-1.1.0.csv,dataset/original//IND-JLMIV+R-2020/calcite/calcite-1.10.0.csv,1310,529,455,0.347328244,5,0,450,0,5,450
IND-JLMIV+R-2020,dataset/original//IND-JLMIV+R-2020/calcite/calcite-1.10.0.csv,dataset/original//IND-JLMIV+R-2020/calcite/calcite-1.11.0.csv,1331,1300,1088,0.817430503,31,12,1045,0,43,1045
IND-JLMIV+R-2020,dataset/original//IND-JLMIV+R-2020/calcite/calcite-1.11.0.csv,dataset/original//IND-JLMIV+R-2020/calcite/calcite-1.12.0.csv,1415,1211,1035,0.731448763,22,4,1009,0,26,1009
IND-JLMIV+R-2020,dataset/original//IND-JLMIV+R-2020/calcite/calcite-1.12.0.csv,dataset/original//IND-JLMIV+R-2020/calcite/calcite-1.13.0.csv,1275,1224,1071,0.84,21,1,1049,0,22,1049
IND-JLMIV+R-2020,dataset/original//IND-JLMIV+R-2020/calcite/calcite-1.13.0.csv,dataset/original//IND-JLMIV+R-2020/calcite/calcite-1.14.0.csv,1308,1145,1000,0.764525994,17,0,983,0,17,983
IND-JLMIV+R-2020,dataset/original//IND-JLMIV+R-2020/calcite/calcite-1.14.0.csv,dataset/original//IND-JLMIV+R-2020/calcite/calcite-1.15.0.csv,1352,1250,1087,0.803994083,23,0,1064,0,23,1064
IND-JLMIV+R-2020,dataset/original//IND-JLMIV+R-2020/calcite/calcite-1.15.0.csv,dataset/original//IND-JLMIV+R-2020/calcite/calcite-1.2.0.csv,1108,0,0,0,0,0,0,0,0,0
IND-JLMIV+R-2020,dataset/original//IND-JLMIV+R-2020/calcite/calcite-1.2.0.csv,dataset/original//IND-JLMIV+R-2020/calcite/calcite-1.3.0.csv,1115,0,0,0,0,0,0,0,0,0
IND-JLMIV+R-2020,dataset/original//IND-JLMIV+R-2020/calcite/calcite-1.3.0.csv,dataset/original//IND-JLMIV+R-2020/calcite/calcite-1.4.0.csv,1127,0,0,0,0,0,0,0,0,0
IND-JLMIV+R-2020,dataset/original//IND-JLMIV+R-2020/calcite/calcite-1.4.0.csv,dataset/original//IND-JLMIV+R-2020/calcite/calcite-1.5.0.csv,1176,976,864,0.734693878,47,3,814,0,50,814
IND-JLMIV+R-2020,dataset/original//IND-JLMIV+R-2020/calcite/calcite-1.5.0.csv,dataset/original//IND-JLMIV+R-2020/calcite/calcite-1.6.0.csv,1193,1010,877,0.735121542,52,1,824,0,53,824
IND-JLMIV+R-2020,dataset/original//IND-JLMIV+R-2020/calcite/calcite-1.6.0.csv,dataset/original//IND-JLMIV+R-2020/calcite/calcite-1.7.0.csv,1252,1116,887,0.708466454,63,6,818,0,69,818
IND-JLMIV+R-2020,dataset/original//IND-JLMIV+R-2020/calcite/calcite-1.7.0.csv,dataset/original//IND-JLMIV+R-2020/calcite/calcite-1.8.0.csv,1301,1241,1059,0.813989239,65,0,994,0,65,994
IND-JLMIV+R-2020,dataset/original//IND-JLMIV+R-2020/calcite/calcite-1.8.0.csv,dataset/original//IND-JLMIV+R-2020/calcite/calcite-1.9.0.csv,1310,1318,1124,0.858015267,45,6,1072,1,51,1073
IND-JLMIV+R-2020,dataset/original//IND-JLMIV+R-2020/cayenne/cayenne-3.0.0.csv,dataset/original//IND-JLMIV+R-2020/cayenne/cayenne-3.1.0.csv,1578,954,479,0.303548796,0,0,479,0,0,479
IND-JLMIV+R-2020,dataset/original//IND-JLMIV+R-2020/commons-bcel/commons-bcel-5.0.csv,dataset/original//IND-JLMIV+R-2020/commons-bcel/commons-bcel-5.1.csv,334,294,261,0.781437126,0,0,261,0,0,261
IND-JLMIV+R-2020,dataset/original//IND-JLMIV+R-2020/commons-bcel/commons-bcel-5.1.csv,dataset/original//IND-JLMIV+R-2020/commons-bcel/commons-bcel-5.2.csv,335,193,184,0.549253731,0,0,184,0,0,184
IND-JLMIV+R-2020,dataset/original//IND-JLMIV+R-2020/commons-bcel/commons-bcel-5.2.csv,dataset/original//IND-JLMIV+R-2020/commons-bcel/commons-bcel-6.0.csv,376,10,5,0.013297872,0,0,5,0,0,5
IND-JLMIV+R-2020,dataset/original//IND-JLMIV+R-2020/commons-bcel/commons-bcel-6.0.csv,dataset/original//IND-JLMIV+R-2020/commons-bcel/commons-bcel-6.1.csv,378,462,0,0,0,0,0,0,0,0
IND-JLMIV+R-2020,dataset/original//IND-JLMIV+R-2020/commons-bcel/commons-bcel-6.1.csv,dataset/original//IND-JLMIV+R-2020/commons-bcel/commons-bcel-6.2.csv,378,477,0,0,0,0,0,0,0,0
IND-JLMIV+R-2020,dataset/original//IND-JLMIV+R-2020/commons-beanutils/commons-beanutils-1.0.csv,dataset/original//IND-JLMIV+R-2020/commons-beanutils/commons-beanutils-1.1.csv,4,10,0,0,0,0,0,0,0,0
IND-JLMIV+R-2020,dataset/original//IND-JLMIV+R-2020/commons-beanutils/commons-beanutils-1.1.csv,dataset/original//IND-JLMIV+R-2020/commons-beanutils/commons-beanutils-1.2.csv,5,9,2,0.4,0,0,2,0,0,2
IND-JLMIV+R-2020,dataset/original//IND-JLMIV+R-2020/commons-beanutils/commons-beanutils-1.2.csv,dataset/original//IND-JLMIV+R-2020/commons-beanutils/commons-beanutils-1.3.csv,29,8,0,0,0,0,0,0,0,0
IND-JLMIV+R-2020,dataset/original//IND-JLMIV+R-2020/commons-beanutils/commons-beanutils-1.3.csv,dataset/original//IND-JLMIV+R-2020/commons-beanutils/commons-beanutils-1.4.csv,43,29,11,0.255813953,0,0,11,0,0,11
IND-JLMIV+R-2020,dataset/original//IND-JLMIV+R-2020/commons-beanutils/commons-beanutils-1.4.csv,dataset/original//IND-JLMIV+R-2020/commons-beanutils/commons-beanutils-1.5.csv,62,64,40,0.64516129,0,0,40,0,0,40
IND-JLMIV+R-2020,dataset/original//IND-JLMIV+R-2020/commons-beanutils/commons-beanutils-1.5.csv,dataset/original//IND-JLMIV+R-2020/commons-beanutils/commons-beanutils-1.6.csv,64,64,43,0.671875,0,0,43,0,0,43
IND-JLMIV+R-2020,dataset/original//IND-JLMIV+R-2020/commons-beanutils/commons-beanutils-1.6.csv,dataset/original//IND-JLMIV+R-2020/commons-beanutils/commons-beanutils-1.7.0.csv,87,77,41,0.471264368,0,0,41,0,0,41
IND-JLMIV+R-2020,dataset/original//IND-JLMIV+R-2020/commons-beanutils/commons-beanutils-1.7.0.csv,dataset/original//IND-JLMIV+R-2020/commons-beanutils/commons-beanutils-1.8.0.csv,101,51,15,0.148514851,0,0,15,0,0,15
IND-JLMIV+R-2020,dataset/original//IND-JLMIV+R-2020/commons-beanutils/commons-beanutils-1.8.0.csv,dataset/original//IND-JLMIV+R-2020/commons-beanutils/commons-beanutils-1.9.0.csv,104,38,9,0.086538462,0,0,9,0,0,9
IND-JLMIV+R-2020,dataset/original//IND-JLMIV+R-2020/commons-codec/commons-codec-1.1.csv,dataset/original//IND-JLMIV+R-2020/commons-codec/commons-codec-1.10.csv,60,0,0,0,0,0,0,0,0,0
IND-JLMIV+R-2020,dataset/original//IND-JLMIV+R-2020/commons-codec/commons-codec-1.10.csv,dataset/original//IND-JLMIV+R-2020/commons-codec/commons-codec-1.11.csv,64,78,0,0,0,0,0,0,0,0
IND-JLMIV+R-2020,dataset/original//IND-JLMIV+R-2020/commons-codec/commons-codec-1.11.csv,dataset/original//IND-JLMIV+R-2020/commons-codec/commons-codec-1.2.csv,17,0,0,0,0,0,0,0,0,0
IND-JLMIV+R-2020,dataset/original//IND-JLMIV+R-2020/commons-codec/commons-codec-1.2.csv,dataset/original//IND-JLMIV+R-2020/commons-codec/commons-codec-1.3.csv,24,15,9,0.375,0,0,9,0,0,9
IND-JLMIV+R-2020,dataset/original//IND-JLMIV+R-2020/commons-codec/commons-codec-1.3.csv,dataset/original//IND-JLMIV+R-2020/commons-codec/commons-codec-1.4.csv,29,10,6,0.206896552,0,0,6,0,0,6
IND-JLMIV+R-2020,dataset/original//IND-JLMIV+R-2020/commons-codec/commons-codec-1.4.csv,dataset/original//IND-JLMIV+R-2020/commons-codec/commons-codec-1.5.csv,39,26,14,0.358974359,0,0,14,0,0,14
IND-JLMIV+R-2020,dataset/original//IND-JLMIV+R-2020/commons-codec/commons-codec-1.5.csv,dataset/original//IND-JLMIV+R-2020/commons-codec/commons-codec-1.6.csv,47,29,26,0.553191489,0,0,26,0,0,26
IND-JLMIV+R-2020,dataset/original//IND-JLMIV+R-2020/commons-codec/commons-codec-1.6.csv,dataset/original//IND-JLMIV+R-2020/commons-codec/commons-codec-1.7.csv,55,38,0,0,0,0,0,0,0,0
IND-JLMIV+R-2020,dataset/original//IND-JLMIV+R-2020/commons-codec/commons-codec-1.7.csv,dataset/original//IND-JLMIV+R-2020/commons-codec/commons-codec-1.8.csv,56,15,0,0,0,0,0,0,0,0
IND-JLMIV+R-2020,dataset/original//IND-JLMIV+R-2020/commons-codec/commons-codec-1.8.csv,dataset/original//IND-JLMIV+R-2020/commons-codec/commons-codec-1.9.csv,56,98,0,0,0,0,0,0,0,0
IND-JLMIV+R-2020,dataset/original//IND-JLMIV+R-2020/commons-collections/commons-collections-1.0.csv,dataset/original//IND-JLMIV+R-2020/commons-collections/commons-collections-2.0.csv,44,16,12,0.272727273,0,0,12,0,0,12
IND-JLMIV+R-2020,dataset/original//IND-JLMIV+R-2020/commons-collections/commons-collections-2.0.csv,dataset/original//IND-JLMIV+R-2020/commons-collections/commons-collections-2.1.csv,72,21,16,0.222222222,1,0,15,0,1,15
IND-JLMIV+R-2020,dataset/original//IND-JLMIV+R-2020/commons-collections/commons-collections-2.1.csv,dataset/original//IND-JLMIV+R-2020/commons-collections/commons-collections-3.0.csv,248,14,10,0.040322581,0,0,10,0,0,10
IND-JLMIV+R-2020,dataset/original//IND-JLMIV+R-2020/commons-collections/commons-collections-3.0.csv,dataset/original//IND-JLMIV+R-2020/commons-collections/commons-collections-3.1.csv,267,180,95,0.355805243,2,0,93,0,2,93
IND-JLMIV+R-2020,dataset/original//IND-JLMIV+R-2020/commons-collections/commons-collections-3.1.csv,dataset/original//IND-JLMIV+R-2020/commons-collections/commons-collections-3.2.csv,273,313,174,0.637362637,4,0,170,0,4,170
IND-JLMIV+R-2020,dataset/original//IND-JLMIV+R-2020/commons-collections/commons-collections-3.2.csv,dataset/original//IND-JLMIV+R-2020/commons-collections/commons-collections-3.3.csv,273,375,233,0.853479853,2,0,231,0,2,231
IND-JLMIV+R-2020,dataset/original//IND-JLMIV+R-2020/commons-collections/commons-collections-3.3.csv,dataset/original//IND-JLMIV+R-2020/commons-collections/commons-collections-4.0.csv,270,2,0,0,0,0,0,0,0,0
IND-JLMIV+R-2020,dataset/original//IND-JLMIV+R-2020/commons-collections/commons-collections-4.0.csv,dataset/original//IND-JLMIV+R-2020/commons-collections/commons-collections-4.1.csv,301,281,0,0,0,0,0,0,0,0
IND-JLMIV+R-2020,dataset/original//IND-JLMIV+R-2020/commons-compress/commons-compress-1.0.csv,dataset/original//IND-JLMIV+R-2020/commons-compress/commons-compress-1.1.csv,66,49,29,0.439393939,3,0,26,0,3,26
IND-JLMIV+R-2020,dataset/original//IND-JLMIV+R-2020/commons-compress/commons-compress-1.1.csv,dataset/original//IND-JLMIV+R-2020/commons-compress/commons-compress-1.10.csv,158,16,14,0.088607595,0,0,14,0,0,14
IND-JLMIV+R-2020,dataset/original//IND-JLMIV+R-2020/commons-compress/commons-compress-1.10.csv,dataset/original//IND-JLMIV+R-2020/commons-compress/commons-compress-1.11.csv,165,224,138,0.836363636,5,0,133,0,5,133
IND-JLMIV+R-2020,dataset/original//IND-JLMIV+R-2020/commons-compress/commons-compress-1.11.csv,dataset/original//IND-JLMIV+R-2020/commons-compress/commons-compress-1.12.csv,166,37,28,0.168674699,0,0,28,0,0,28
IND-JLMIV+R-2020,dataset/original//IND-JLMIV+R-2020/commons-compress/commons-compress-1.12.csv,dataset/original//IND-JLMIV+R-2020/commons-compress/commons-compress-1.13.csv,177,168,110,0.621468927,5,4,101,0,9,101
IND-JLMIV+R-2020,dataset/original//IND-JLMIV+R-2020/commons-compress/commons-compress-1.13.csv,dataset/original//IND-JLMIV+R-2020/commons-compress/commons-compress-1.14.csv,195,232,142,0.728205128,4,0,138,0,4,138
IND-JLMIV+R-2020,dataset/original//IND-JLMIV+R-2020/commons-compress/commons-compress-1.14.csv,dataset/original//IND-JLMIV+R-2020/commons-compress/commons-compress-1.15.csv,195,277,176,0.902564103,4,0,172,0,4,172
IND-JLMIV+R-2020,dataset/original//IND-JLMIV+R-2020/commons-compress/commons-compress-1.15.csv,dataset/original//IND-JLMIV+R-2020/commons-compress/commons-compress-1.16.csv,201,276,151,0.751243781,0,1,150,0,1,150
IND-JLMIV+R-2020,dataset/original//IND-JLMIV+R-2020/commons-compress/commons-compress-1.16.csv,dataset/original//IND-JLMIV+R-2020/commons-compress/commons-compress-1.2.csv,69,3,2,0.028985507,0,0,2,0,0,2
IND-JLMIV+R-2020,dataset/original//IND-JLMIV+R-2020/commons-compress/commons-compress-1.2.csv,dataset/original//IND-JLMIV+R-2020/commons-compress/commons-compress-1.3.csv,93,52,27,0.290322581,1,0,26,0,1,26
IND-JLMIV+R-2020,dataset/original//IND-JLMIV+R-2020/commons-compress/commons-compress-1.3.csv,dataset/original//IND-JLMIV+R-2020/commons-compress/commons-compress-1.4.csv,99,93,64,0.646464646,4,1,59,0,5,59
IND-JLMIV+R-2020,dataset/original//IND-JLMIV+R-2020/commons-compress/commons-compress-1.4.csv,dataset/original//IND-JLMIV+R-2020/commons-compress/commons-compress-1.5.csv,103,99,62,0.601941748,2,0,60,0,2,60
IND-JLMIV+R-2020,dataset/original//IND-JLMIV+R-2020/commons-compress/commons-compress-1.5.csv,dataset/original//IND-JLMIV+R-2020/commons-compress/commons-compress-1.6.csv,124,129,76,0.612903226,6,0,70,0,6,70
IND-JLMIV+R-2020,dataset/original//IND-JLMIV+R-2020/commons-compress/commons-compress-1.6.csv,dataset/original//IND-JLMIV+R-2020/commons-compress/commons-compress-1.7.csv,136,139,79,0.580882353,6,2,71,0,8,71
IND-JLMIV+R-2020,dataset/original//IND-JLMIV+R-2020/commons-compress/commons-compress-1.7.csv,dataset/original//IND-JLMIV+R-2020/commons-compress/commons-compress-1.8.csv,141,188,117,0.829787234,17,0,100,0,17,100
IND-JLMIV+R-2020,dataset/original//IND-JLMIV+R-2020/commons-compress/commons-compress-1.8.csv,dataset/original//IND-JLMIV+R-2020/commons-compress/commons-compress-1.9.csv,145,182,111,0.765517241,12,2,97,0,14,97
IND-JLMIV+R-2020,dataset/original//IND-JLMIV+R-2020/commons-configuration/commons-configuration-1.0.csv,dataset/original//IND-JLMIV+R-2020/commons-configuration/commons-configuration-1.1.csv,42,28,12,0.285714286,0,0,12,0,0,12
IND-JLMIV+R-2020,dataset/original//IND-JLMIV+R-2020/commons-configuration/commons-configuration-1.1.csv,dataset/original//IND-JLMIV+R-2020/commons-configuration/commons-configuration-1.10.csv,108,5,4,0.037037037,0,0,4,0,0,4
IND-JLMIV+R-2020,dataset/original//IND-JLMIV+R-2020/commons-configuration/commons-configuration-1.10.csv,dataset/original//IND-JLMIV+R-2020/commons-configuration/commons-configuration-1.2.csv,53,5,0,0,0,0,0,0,0,0
IND-JLMIV+R-2020,dataset/original//IND-JLMIV+R-2020/commons-configuration/commons-configuration-1.2.csv,dataset/original//IND-JLMIV+R-2020/commons-configuration/commons-configuration-1.3.csv,84,61,26,0.30952381,4,1,21,0,5,21
IND-JLMIV+R-2020,dataset/original//IND-JLMIV+R-2020/commons-configuration/commons-configuration-1.3.csv,dataset/original//IND-JLMIV+R-2020/commons-configuration/commons-configuration-1.4.csv,91,107,56,0.615384615,4,0,52,0,4,52
IND-JLMIV+R-2020,dataset/original//IND-JLMIV+R-2020/commons-configuration/commons-configuration-1.4.csv,dataset/original//IND-JLMIV+R-2020/commons-configuration/commons-configuration-1.5.csv,92,125,63,0.684782609,1,0,62,0,1,62
IND-JLMIV+R-2020,dataset/original//IND-JLMIV+R-2020/commons-configuration/commons-configuration-1.5.csv,dataset/original//IND-JLMIV+R-2020/commons-configuration/commons-configuration-1.6.csv,96,152,70,0.729166667,2,0,68,0,2,68
IND-JLMIV+R-2020,dataset/original//IND-JLMIV+R-2020/commons-configuration/commons-configuration-1.6.csv,dataset/original//IND-JLMIV+R-2020/commons-configuration/commons-configuration-1.7.csv,114,133,65,0.570175439,1,0,64,0,1,64
IND-JLMIV+R-2020,dataset/original//IND-JLMIV+R-2020/commons-configuration/commons-configuration-1.7.csv,dataset/original//IND-JLMIV+R-2020/commons-configuration/commons-configuration-1.8.csv,108,35,25,0.231481481,0,0,25,0,0,25
IND-JLMIV+R-2020,dataset/original//IND-JLMIV+R-2020/commons-configuration/commons-configuration-1.8.csv,dataset/original//IND-JLMIV+R-2020/commons-configuration/commons-configuration-1.9.csv,108,179,0,0,0,0,0,0,0,0
IND-JLMIV+R-2020,dataset/original//IND-JLMIV+R-2020/commons-configuration/commons-configuration-1.9.csv,dataset/original//IND-JLMIV+R-2020/commons-configuration/commons-configuration-2.0.csv,231,1,0,0,0,0,0,0,0,0
IND-JLMIV+R-2020,dataset/original//IND-JLMIV+R-2020/commons-configuration/commons-configuration-2.0.csv,dataset/original//IND-JLMIV+R-2020/commons-configuration/commons-configuration-2.1.csv,233,413,0,0,0,0,0,0,0,0
IND-JLMIV+R-2020,dataset/original//IND-JLMIV+R-2020/commons-configuration/commons-configuration-2.1.csv,dataset/original//IND-JLMIV+R-2020/commons-configuration/commons-configuration-2.2.csv,240,265,0,0,0,0,0,0,0,0
IND-JLMIV+R-2020,dataset/original//IND-JLMIV+R-2020/commons-dbcp/commons-dbcp-1.0.csv,dataset/original//IND-JLMIV+R-2020/commons-dbcp/commons-dbcp-1.1.csv,39,8,5,0.128205128,0,0,5,0,0,5
IND-JLMIV+R-2020,dataset/original//IND-JLMIV+R-2020/commons-dbcp/commons-dbcp-1.1.csv,dataset/original//IND-JLMIV+R-2020/commons-dbcp/commons-dbcp-1.2.csv,39,28,19,0.487179487,3,2,14,0,5,14
IND-JLMIV+R-2020,dataset/original//IND-JLMIV+R-2020/commons-dbcp/commons-dbcp-1.2.csv,dataset/original//IND-JLMIV+R-2020/commons-dbcp/commons-dbcp-1.3.csv,53,11,8,0.150943396,0,0,8,0,0,8
IND-JLMIV+R-2020,dataset/original//IND-JLMIV+R-2020/commons-dbcp/commons-dbcp-1.3.csv,dataset/original//IND-JLMIV+R-2020/commons-dbcp/commons-dbcp-1.4.csv,53,81,43,0.811320755,6,0,37,0,6,37
IND-JLMIV+R-2020,dataset/original//IND-JLMIV+R-2020/commons-dbcp/commons-dbcp-1.4.csv,dataset/original//IND-JLMIV+R-2020/commons-dbcp/commons-dbcp-2.0.csv,53,1,0,0,0,0,0,0,0,0
IND-JLMIV+R-2020,dataset/original//IND-JLMIV+R-2020/commons-dbcp/commons-dbcp-2.0.csv,dataset/original//IND-JLMIV+R-2020/commons-dbcp/commons-dbcp-2.1.csv,54,45,0,0,0,0,0,0,0,0
IND-JLMIV+R-2020,dataset/original//IND-JLMIV+R-2020/commons-dbcp/commons-dbcp-2.1.csv,dataset/original//IND-JLMIV+R-2020/commons-dbcp/commons-dbcp-2.2.0.csv,54,15,0,0,0,0,0,0,0,0
IND-JLMIV+R-2020,dataset/original//IND-JLMIV+R-2020/commons-dbcp/commons-dbcp-2.2.0.csv,dataset/original//IND-JLMIV+R-2020/commons-dbcp/commons-dbcp-2.3.0.csv,55,94,0,0,0,0,0,0,0,0
IND-JLMIV+R-2020,dataset/original//IND-JLMIV+R-2020/commons-dbcp/commons-dbcp-2.3.0.csv,dataset/original//IND-JLMIV+R-2020/commons-dbcp/commons-dbcp-2.4.0.csv,56,46,0,0,0,0,0,0,0,0
IND-JLMIV+R-2020,dataset/original//IND-JLMIV+R-2020/commons-dbcp/commons-dbcp-2.4.0.csv,dataset/original//IND-JLMIV+R-2020/commons-dbcp/commons-dbcp-2.5.0.csv,56,64,0,0,0,0,0,0,0,0
IND-JLMIV+R-2020,dataset/original//IND-JLMIV+R-2020/commons-digester/commons-digester-1.0.csv,dataset/original//IND-JLMIV+R-2020/commons-digester/commons-digester-1.1.csv,22,6,4,0.181818182,0,0,4,0,0,4
IND-JLMIV+R-2020,dataset/original//IND-JLMIV+R-2020/commons-digester/commons-digester-1.1.csv,dataset/original//IND-JLMIV+R-2020/commons-digester/commons-digester-1.2.csv,31,10,7,0.225806452,0,0,7,0,0,7
IND-JLMIV+R-2020,dataset/original//IND-JLMIV+R-2020/commons-digester/commons-digester-1.2.csv,dataset/original//IND-JLMIV+R-2020/commons-digester/commons-digester-1.3.csv,31,40,25,0.806451613,0,0,25,0,0,25
IND-JLMIV+R-2020,dataset/original//IND-JLMIV+R-2020/commons-digester/commons-digester-1.3.csv,dataset/original//IND-JLMIV+R-2020/commons-digester/commons-digester-1.4.csv,33,38,21,0.636363636,0,0,21,0,0,21
IND-JLMIV+R-2020,dataset/original//IND-JLMIV+R-2020/commons-digester/commons-digester-1.4.csv,dataset/original//IND-JLMIV+R-2020/commons-digester/commons-digester-1.5.csv,37,29,14,0.378378378,1,0,13,0,1,13
IND-JLMIV+R-2020,dataset/original//IND-JLMIV+R-2020/commons-digester/commons-digester-1.5.csv,dataset/original//IND-JLMIV+R-2020/commons-digester/commons-digester-1.6.csv,68,49,21,0.308823529,0,0,21,0,0,21
IND-JLMIV+R-2020,dataset/original//IND-JLMIV+R-2020/commons-digester/commons-digester-1.6.csv,dataset/original//IND-JLMIV+R-2020/commons-digester/commons-digester-1.7.csv,69,115,49,0.710144928,1,0,48,0,1,48
IND-JLMIV+R-2020,dataset/original//IND-JLMIV+R-2020/commons-digester/commons-digester-1.7.csv,dataset/original//IND-JLMIV+R-2020/commons-digester/commons-digester-1.8.csv,70,135,57,0.814285714,1,0,56,0,1,56
IND-JLMIV+R-2020,dataset/original//IND-JLMIV+R-2020/commons-digester/commons-digester-1.8.csv,dataset/original//IND-JLMIV+R-2020/commons-digester/commons-digester-2.0.csv,70,84,23,0.328571429,0,0,23,0,0,23
IND-JLMIV+R-2020,dataset/original//IND-JLMIV+R-2020/commons-digester/commons-digester-2.0.csv,dataset/original//IND-JLMIV+R-2020/commons-digester/commons-digester-2.1.csv,114,63,21,0.184210526,0,0,21,0,0,21
IND-JLMIV+R-2020,dataset/original//IND-JLMIV+R-2020/commons-digester/commons-digester-2.1.csv,dataset/original//IND-JLMIV+R-2020/commons-digester/commons-digester-3.0.csv,154,2,0,0,0,0,0,0,0,0
IND-JLMIV+R-2020,dataset/original//IND-JLMIV+R-2020/commons-digester/commons-digester-3.0.csv,dataset/original//IND-JLMIV+R-2020/commons-digester/commons-digester-3.1.csv,154,242,0,0,0,0,0,0,0,0
IND-JLMIV+R-2020,dataset/original//IND-JLMIV+R-2020/commons-digester/commons-digester-3.1.csv,dataset/original//IND-JLMIV+R-2020/commons-digester/commons-digester-3.2.csv,157,228,0,0,0,0,0,0,0,0
IND-JLMIV+R-2020,dataset/original//IND-JLMIV+R-2020/commons-io/commons-io-1.0.csv,dataset/original//IND-JLMIV+R-2020/commons-io/commons-io-1.1.csv,39,30,16,0.41025641,2,0,14,0,2,14
IND-JLMIV+R-2020,dataset/original//IND-JLMIV+R-2020/commons-io/commons-io-1.1.csv,dataset/original//IND-JLMIV+R-2020/commons-io/commons-io-1.2.csv,42,63,34,0.80952381,5,0,29,0,5,29
IND-JLMIV+R-2020,dataset/original//IND-JLMIV+R-2020/commons-io/commons-io-1.2.csv,dataset/original//IND-JLMIV+R-2020/commons-io/commons-io-1.3.csv,54,53,24,0.444444444,4,0,20,0,4,20
IND-JLMIV+R-2020,dataset/original//IND-JLMIV+R-2020/commons-io/commons-io-1.3.csv,dataset/original//IND-JLMIV+R-2020/commons-io/commons-io-1.4.csv,72,43,21,0.291666667,7,0,14,0,7,14
IND-JLMIV+R-2020,dataset/original//IND-JLMIV+R-2020/commons-io/commons-io-1.4.csv,dataset/original//IND-JLMIV+R-2020/commons-io/commons-io-2.0.csv,100,16,5,0.05,0,0,5,0,0,5
IND-JLMIV+R-2020,dataset/original//IND-JLMIV+R-2020/commons-io/commons-io-2.0.csv,dataset/original//IND-JLMIV+R-2020/commons-io/commons-io-2.1.csv,100,152,0,0,0,0,0,0,0,0
IND-JLMIV+R-2020,dataset/original//IND-JLMIV+R-2020/commons-io/commons-io-2.1.csv,dataset/original//IND-JLMIV+R-2020/commons-io/commons-io-2.2.csv,102,132,0,0,0,0,0,0,0,0
IND-JLMIV+R-2020,dataset/original//IND-JLMIV+R-2020/commons-io/commons-io-2.2.csv,dataset/original//IND-JLMIV+R-2020/commons-io/commons-io-2.3.csv,103,178,0,0,0,0,0,0,0,0
IND-JLMIV+R-2020,dataset/original//IND-JLMIV+R-2020/commons-io/commons-io-2.3.csv,dataset/original//IND-JLMIV+R-2020/commons-io/commons-io-2.4.csv,103,187,0,0,0,0,0,0,0,0
IND-JLMIV+R-2020,dataset/original//IND-JLMIV+R-2020/commons-io/commons-io-2.4.csv,dataset/original//IND-JLMIV+R-2020/commons-io/commons-io-2.5.csv,115,8,0,0,0,0,0,0,0,0
IND-JLMIV+R-2020,dataset/original//IND-JLMIV+R-2020/commons-jcs/commons-jcs-1.0.csv,dataset/original//IND-JLMIV+R-2020/commons-jcs/commons-jcs-1.1.csv,213,52,39,0.183098592,0,0,39,0,0,39
IND-JLMIV+R-2020,dataset/original//IND-JLMIV+R-2020/commons-jcs/commons-jcs-1.1.csv,dataset/original//IND-JLMIV+R-2020/commons-jcs/commons-jcs-1.3.csv,275,56,48,0.174545455,0,1,47,0,1,47
IND-JLMIV+R-2020,dataset/original//IND-JLMIV+R-2020/commons-jcs/commons-jcs-1.3.csv,dataset/original//IND-JLMIV+R-2020/commons-jcs/commons-jcs-2.0.csv,368,1,0,0,0,0,0,0,0,0
IND-JLMIV+R-2020,dataset/original//IND-JLMIV+R-2020/commons-jcs/commons-jcs-2.0.csv,dataset/original//IND-JLMIV+R-2020/commons-jcs/commons-jcs-2.1.csv,368,544,62,0.168478261,2,0,60,0,2,60
IND-JLMIV+R-2020,dataset/original//IND-JLMIV+R-2020/commons-jcs/commons-jcs-2.1.csv,dataset/original//IND-JLMIV+R-2020/commons-jcs/commons-jcs-2.2.csv,368,533,60,0.163043478,2,0,58,0,2,58
IND-JLMIV+R-2020,dataset/original//IND-JLMIV+R-2020/commons-jexl/commons-jexl-1.0.csv,dataset/original//IND-JLMIV+R-2020/commons-jexl/commons-jexl-1.1.csv,85,34,26,0.305882353,0,0,26,0,0,26
IND-JLMIV+R-2020,dataset/original//IND-JLMIV+R-2020/commons-jexl/commons-jexl-1.1.csv,dataset/original//IND-JLMIV+R-2020/commons-jexl/commons-jexl-2.0.csv,52,4,0,0,0,0,0,0,0,0
IND-JLMIV+R-2020,dataset/original//IND-JLMIV+R-2020/commons-jexl/commons-jexl-2.0.csv,dataset/original//IND-JLMIV+R-2020/commons-jexl/commons-jexl-2.1.csv,69,45,0,0,0,0,0,0,0,0
IND-JLMIV+R-2020,dataset/original//IND-JLMIV+R-2020/commons-jexl/commons-jexl-2.1.csv,dataset/original//IND-JLMIV+R-2020/commons-jexl/commons-jexl-3.0.csv,82,0,0,0,0,0,0,0,0,0
IND-JLMIV+R-2020,dataset/original//IND-JLMIV+R-2020/commons-jexl/commons-jexl-3.0.csv,dataset/original//IND-JLMIV+R-2020/commons-jexl/commons-jexl-3.1.csv,85,79,0,0,0,0,0,0,0,0
IND-JLMIV+R-2020,dataset/original//IND-JLMIV+R-2020/commons-lang/commons-lang-1.0.csv,dataset/original//IND-JLMIV+R-2020/commons-lang/commons-lang-2.0.csv,57,8,2,0.035087719,0,0,2,0,0,2
IND-JLMIV+R-2020,dataset/original//IND-JLMIV+R-2020/commons-lang/commons-lang-2.0.csv,dataset/original//IND-JLMIV+R-2020/commons-lang/commons-lang-2.1.csv,74,64,16,0.216216216,1,0,15,0,1,15
IND-JLMIV+R-2020,dataset/original//IND-JLMIV+R-2020/commons-lang/commons-lang-2.1.csv,dataset/original//IND-JLMIV+R-2020/commons-lang/commons-lang-2.2.csv,77,70,17,0.220779221,0,0,17,0,0,17
IND-JLMIV+R-2020,dataset/original//IND-JLMIV+R-2020/commons-lang/commons-lang-2.2.csv,dataset/original//IND-JLMIV+R-2020/commons-lang/commons-lang-2.3.csv,77,156,51,0.662337662,6,0,45,0,6,45
IND-JLMIV+R-2020,dataset/original//IND-JLMIV+R-2020/commons-lang/commons-lang-2.3.csv,dataset/original//IND-JLMIV+R-2020/commons-lang/commons-lang-2.4.csv,80,125,43,0.5375,3,0,40,0,3,40
IND-JLMIV+R-2020,dataset/original//IND-JLMIV+R-2020/commons-lang/commons-lang-2.4.csv,dataset/original//IND-JLMIV+R-2020/commons-lang/commons-lang-2.5.csv,85,70,41,0.482352941,2,0,39,0,2,39
IND-JLMIV+R-2020,dataset/original//IND-JLMIV+R-2020/commons-lang/commons-lang-2.5.csv,dataset/original//IND-JLMIV+R-2020/commons-lang/commons-lang-2.6.csv,86,166,0,0,0,0,0,0,0,0
IND-JLMIV+R-2020,dataset/original//IND-JLMIV+R-2020/commons-lang/commons-lang-2.6.csv,dataset/original//IND-JLMIV+R-2020/commons-lang/commons-lang-3.0.csv,99,2,0,0,0,0,0,0,0,0
IND-JLMIV+R-2020,dataset/original//IND-JLMIV+R-2020/commons-lang/commons-lang-3.0.csv,dataset/original//IND-JLMIV+R-2020/commons-lang/commons-lang-3.1.csv,99,123,0,0,0,0,0,0,0,0
IND-JLMIV+R-2020,dataset/original//IND-JLMIV+R-2020/commons-lang/commons-lang-3.1.csv,dataset/original//IND-JLMIV+R-2020/commons-lang/commons-lang-3.2.csv,112,14,0,0,0,0,0,0,0,0
IND-JLMIV+R-2020,dataset/original//IND-JLMIV+R-2020/commons-lang/commons-lang-3.2.csv,dataset/original//IND-JLMIV+R-2020/commons-lang/commons-lang-3.3.csv,120,192,0,0,0,0,0,0,0,0
IND-JLMIV+R-2020,dataset/original//IND-JLMIV+R-2020/commons-lang/commons-lang-3.3.csv,dataset/original//IND-JLMIV+R-2020/commons-lang/commons-lang-3.4.csv,121,157,0,0,0,0,0,0,0,0
IND-JLMIV+R-2020,dataset/original//IND-JLMIV+R-2020/commons-lang/commons-lang-3.4.csv,dataset/original//IND-JLMIV+R-2020/commons-lang/commons-lang-3.5.csv,131,156,0,0,0,0,0,0,0,0
IND-JLMIV+R-2020,dataset/original//IND-JLMIV+R-2020/commons-lang/commons-lang-3.5.csv,dataset/original//IND-JLMIV+R-2020/commons-lang/commons-lang-3.6.csv,135,75,0,0,0,0,0,0,0,0
IND-JLMIV+R-2020,dataset/original//IND-JLMIV+R-2020/commons-lang/commons-lang-3.6.csv,dataset/original//IND-JLMIV+R-2020/commons-lang/commons-lang-3.7.csv,138,213,0,0,0,0,0,0,0,0
IND-JLMIV+R-2020,dataset/original//IND-JLMIV+R-2020/commons-math/commons-math-1.0.csv,dataset/original//IND-JLMIV+R-2020/commons-math/commons-math-1.1.csv,120,103,0,0,0,0,0,0,0,0
IND-JLMIV+R-2020,dataset/original//IND-JLMIV+R-2020/commons-math/commons-math-1.1.csv,dataset/original//IND-JLMIV+R-2020/commons-math/commons-math-1.2.csv,223,112,0,0,0,0,0,0,0,0
IND-JLMIV+R-2020,dataset/original//IND-JLMIV+R-2020/commons-math/commons-math-1.2.csv,dataset/original//IND-JLMIV+R-2020/commons-math/commons-math-2.0.csv,388,40,0,0,0,0,0,0,0,0
IND-JLMIV+R-2020,dataset/original//IND-JLMIV+R-2020/commons-math/commons-math-2.0.csv,dataset/original//IND-JLMIV+R-2020/commons-math/commons-math-2.1.csv,408,287,168,0.411764706,6,1,161,0,7,161
IND-JLMIV+R-2020,dataset/original//IND-JLMIV+R-2020/commons-math/commons-math-2.1.csv,dataset/original//IND-JLMIV+R-2020/commons-math/commons-math-2.2.csv,457,253,156,0.341356674,3,0,153,0,3,153
IND-JLMIV+R-2020,dataset/original//IND-JLMIV+R-2020/commons-math/commons-math-2.2.csv,dataset/original//IND-JLMIV+R-2020/commons-math/commons-math-3.0.csv,568,3,0,0,0,0,0,0,0,0
IND-JLMIV+R-2020,dataset/original//IND-JLMIV+R-2020/commons-math/commons-math-3.0.csv,dataset/original//IND-JLMIV+R-2020/commons-math/commons-math-3.1.csv,693,408,0,0,0,0,0,0,0,0
IND-JLMIV+R-2020,dataset/original//IND-JLMIV+R-2020/commons-math/commons-math-3.1.csv,dataset/original//IND-JLMIV+R-2020/commons-math/commons-math-3.2.csv,725,897,0,0,0,0,0,0,0,0
IND-JLMIV+R-2020,dataset/original//IND-JLMIV+R-2020/commons-math/commons-math-3.2.csv,dataset/original//IND-JLMIV+R-2020/commons-math/commons-math-3.3.csv,825,818,0,0,0,0,0,0,0,0
IND-JLMIV+R-2020,dataset/original//IND-JLMIV+R-2020/commons-math/commons-math-3.3.csv,dataset/original//IND-JLMIV+R-2020/commons-math/commons-math-3.4.csv,852,1137,0,0,0,0,0,0,0,0
IND-JLMIV+R-2020,dataset/original//IND-JLMIV+R-2020/commons-math/commons-math-3.4.csv,dataset/original//IND-JLMIV+R-2020/commons-math/commons-math-3.5.csv,852,1296,0,0,0,0,0,0,0,0
IND-JLMIV+R-2020,dataset/original//IND-JLMIV+R-2020/commons-math/commons-math-3.5.csv,dataset/original//IND-JLMIV+R-2020/commons-math/commons-math-3.6.csv,914,1091,0,0,0,0,0,0,0,0
IND-JLMIV+R-2020,dataset/original//IND-JLMIV+R-2020/commons-net/commons-net-1.0.csv,dataset/original//IND-JLMIV+R-2020/commons-net/commons-net-1.1.csv,108,102,77,0.712962963,5,1,71,0,6,71
IND-JLMIV+R-2020,dataset/original//IND-JLMIV+R-2020/commons-net/commons-net-1.1.csv,dataset/original//IND-JLMIV+R-2020/commons-net/commons-net-1.2.csv,117,126,90,0.769230769,8,0,82,0,8,82
IND-JLMIV+R-2020,dataset/original//IND-JLMIV+R-2020/commons-net/commons-net-1.2.csv,dataset/original//IND-JLMIV+R-2020/commons-net/commons-net-1.3.csv,129,127,92,0.713178295,7,0,85,0,7,85
IND-JLMIV+R-2020,dataset/original//IND-JLMIV+R-2020/commons-net/commons-net-1.3.csv,dataset/original//IND-JLMIV+R-2020/commons-net/commons-net-1.4.csv,270,304,108,0.4,13,0,95,0,13,95
IND-JLMIV+R-2020,dataset/original//IND-JLMIV+R-2020/commons-net/commons-net-1.4.csv,dataset/original//IND-JLMIV+R-2020/commons-net/commons-net-2.0.csv,126,61,41,0.325396825,2,0,39,0,2,39
IND-JLMIV+R-2020,dataset/original//IND-JLMIV+R-2020/commons-net/commons-net-2.0.csv,dataset/original//IND-JLMIV+R-2020/commons-net/commons-net-2.1.csv,130,116,0,0,0,0,0,0,0,0
IND-JLMIV+R-2020,dataset/original//IND-JLMIV+R-2020/commons-net/commons-net-2.1.csv,dataset/original//IND-JLMIV+R-2020/commons-net/commons-net-2.2.csv,132,126,0,0,0,0,0,0,0,0
IND-JLMIV+R-2020,dataset/original//IND-JLMIV+R-2020/commons-net/commons-net-2.2.csv,dataset/original//IND-JLMIV+R-2020/commons-net/commons-net-3.0.csv,152,117,0,0,0,0,0,0,0,0
IND-JLMIV+R-2020,dataset/original//IND-JLMIV+R-2020/commons-net/commons-net-3.0.csv,dataset/original//IND-JLMIV+R-2020/commons-net/commons-net-3.1.csv,153,147,0,0,0,0,0,0,0,0
IND-JLMIV+R-2020,dataset/original//IND-JLMIV+R-2020/commons-net/commons-net-3.1.csv,dataset/original//IND-JLMIV+R-2020/commons-net/commons-net-3.2.csv,153,170,0,0,0,0,0,0,0,0
IND-JLMIV+R-2020,dataset/original//IND-JLMIV+R-2020/commons-net/commons-net-3.2.csv,dataset/original//IND-JLMIV+R-2020/commons-net/commons-net-3.3.csv,155,188,0,0,0,0,0,0,0,0
IND-JLMIV+R-2020,dataset/original//IND-JLMIV+R-2020/commons-net/commons-net-3.3.csv,dataset/original//IND-JLMIV+R-2020/commons-net/commons-net-3.4.csv,156,153,0,0,0,0,0,0,0,0
IND-JLMIV+R-2020,dataset/original//IND-JLMIV+R-2020/commons-net/commons-net-3.4.csv,dataset/original//IND-JLMIV+R-2020/commons-net/commons-net-3.5.csv,156,187,0,0,0,0,0,0,0,0
IND-JLMIV+R-2020,dataset/original//IND-JLMIV+R-2020/commons-net/commons-net-3.5.csv,dataset/original//IND-JLMIV+R-2020/commons-net/commons-net-3.6.csv,156,215,0,0,0,0,0,0,0,0
IND-JLMIV+R-2020,dataset/original//IND-JLMIV+R-2020/commons-scxml/commons-scxml-0.5.csv,dataset/original//IND-JLMIV+R-2020/commons-scxml/commons-scxml-0.6.csv,75,56,16,0.213333333,2,0,14,0,2,14
IND-JLMIV+R-2020,dataset/original//IND-JLMIV+R-2020/commons-scxml/commons-scxml-0.6.csv,dataset/original//IND-JLMIV+R-2020/commons-scxml/commons-scxml-0.7.csv,79,81,50,0.632911392,6,1,43,0,7,43
IND-JLMIV+R-2020,dataset/original//IND-JLMIV+R-2020/commons-scxml/commons-scxml-0.7.csv,dataset/original//IND-JLMIV+R-2020/commons-scxml/commons-scxml-0.8.csv,79,134,75,0.949367089,13,0,62,0,13,62
IND-JLMIV+R-2020,dataset/original//IND-JLMIV+R-2020/commons-scxml/commons-scxml-0.8.csv,dataset/original//IND-JLMIV+R-2020/commons-scxml/commons-scxml-0.9.csv,79,112,58,0.734177215,1,0,57,0,1,57
IND-JLMIV+R-2020,dataset/original//IND-JLMIV+R-2020/commons-validator/commons-validator-1.0.csv,dataset/original//IND-JLMIV+R-2020/commons-validator/commons-validator-1.1.0.csv,23,5,1,0.043478261,0,0,1,0,0,1
IND-JLMIV+R-2020,dataset/original//IND-JLMIV+R-2020/commons-validator/commons-validator-1.1.0.csv,dataset/original//IND-JLMIV+R-2020/commons-validator/commons-validator-1.2.0.csv,22,24,2,0.090909091,0,0,2,0,0,2
IND-JLMIV+R-2020,dataset/original//IND-JLMIV+R-2020/commons-validator/commons-validator-1.2.0.csv,dataset/original//IND-JLMIV+R-2020/commons-validator/commons-validator-1.3.0.csv,38,42,9,0.236842105,3,0,6,0,3,6
IND-JLMIV+R-2020,dataset/original//IND-JLMIV+R-2020/commons-validator/commons-validator-1.3.0.csv,dataset/original//IND-JLMIV+R-2020/commons-validator/commons-validator-1.4.0.csv,59,25,2,0.033898305,0,0,2,0,0,2
IND-JLMIV+R-2020,dataset/original//IND-JLMIV+R-2020/commons-validator/commons-validator-1.4.0.csv,dataset/original//IND-JLMIV+R-2020/commons-validator/commons-validator-1.5.0.csv,62,66,0,0,0,0,0,0,0,0
IND-JLMIV+R-2020,dataset/original//IND-JLMIV+R-2020/commons-validator/commons-validator-1.5.0.csv,dataset/original//IND-JLMIV+R-2020/commons-validator/commons-validator-1.6.0.csv,63,34,0,0,0,0,0,0,0,0
IND-JLMIV+R-2020,dataset/original//IND-JLMIV+R-2020/commons-vfs/commons-vfs-1.0.csv,dataset/original//IND-JLMIV+R-2020/commons-vfs/commons-vfs-2.0.csv,251,3,0,0,0,0,0,0,0,0
IND-JLMIV+R-2020,dataset/original//IND-JLMIV+R-2020/commons-vfs/commons-vfs-2.0.csv,dataset/original//IND-JLMIV+R-2020/commons-vfs/commons-vfs-2.1.csv,259,67,0,0,0,0,0,0,0,0
IND-JLMIV+R-2020,dataset/original//IND-JLMIV+R-2020/commons-vfs/commons-vfs-2.1.csv,dataset/original//IND-JLMIV+R-2020/commons-vfs/commons-vfs-2.2.csv,262,251,0,0,0,0,0,0,0,0
IND-JLMIV+R-2020,dataset/original//IND-JLMIV+R-2020/deltaspike/deltaspike-0.1.csv,dataset/original//IND-JLMIV+R-2020/deltaspike/deltaspike-0.2.csv,188,51,28,0.14893617,0,0,28,0,0,28
IND-JLMIV+R-2020,dataset/original//IND-JLMIV+R-2020/deltaspike/deltaspike-0.2.csv,dataset/original//IND-JLMIV+R-2020/deltaspike/deltaspike-0.3.csv,181,152,68,0.375690608,4,1,63,0,5,63
IND-JLMIV+R-2020,dataset/original//IND-JLMIV+R-2020/deltaspike/deltaspike-0.3.csv,dataset/original//IND-JLMIV+R-2020/deltaspike/deltaspike-0.4.csv,314,241,118,0.375796178,7,1,110,0,8,110
IND-JLMIV+R-2020,dataset/original//IND-JLMIV+R-2020/deltaspike/deltaspike-0.4.csv,dataset/original//IND-JLMIV+R-2020/deltaspike/deltaspike-0.5.csv,492,564,296,0.601626016,15,1,279,1,16,280
IND-JLMIV+R-2020,dataset/original//IND-JLMIV+R-2020/deltaspike/deltaspike-0.5.csv,dataset/original//IND-JLMIV+R-2020/deltaspike/deltaspike-0.6.csv,578,693,379,0.655709343,8,0,371,0,8,371
IND-JLMIV+R-2020,dataset/original//IND-JLMIV+R-2020/deltaspike/deltaspike-0.6.csv,dataset/original//IND-JLMIV+R-2020/deltaspike/deltaspike-0.7.csv,589,987,549,0.932088285,24,0,525,0,24,525
IND-JLMIV+R-2020,dataset/original//IND-JLMIV+R-2020/deltaspike/deltaspike-0.7.csv,dataset/original//IND-JLMIV+R-2020/deltaspike/deltaspike-1.0.0.csv,615,974,548,0.891056911,23,0,525,0,23,525
IND-JLMIV+R-2020,dataset/original//IND-JLMIV+R-2020/deltaspike/deltaspike-1.0.0.csv,dataset/original//IND-JLMIV+R-2020/deltaspike/deltaspike-1.1.0.csv,634,1016,539,0.850157729,17,0,522,0,17,522
IND-JLMIV+R-2020,dataset/original//IND-JLMIV+R-2020/deltaspike/deltaspike-1.1.0.csv,dataset/original//IND-JLMIV+R-2020/deltaspike/deltaspike-1.2.0.csv,636,1160,606,0.952830189,19,0,587,0,19,587
IND-JLMIV+R-2020,dataset/original//IND-JLMIV+R-2020/deltaspike/deltaspike-1.2.0.csv,dataset/original//IND-JLMIV+R-2020/deltaspike/deltaspike-1.3.0.csv,645,1102,567,0.879069767,13,0,554,0,13,554
IND-JLMIV+R-2020,dataset/original//IND-JLMIV+R-2020/deltaspike/deltaspike-1.3.0.csv,dataset/original//IND-JLMIV+R-2020/deltaspike/deltaspike-1.4.0.csv,649,1143,574,0.884437596,14,0,560,0,14,560
IND-JLMIV+R-2020,dataset/original//IND-JLMIV+R-2020/deltaspike/deltaspike-1.4.0.csv,dataset/original//IND-JLMIV+R-2020/deltaspike/deltaspike-1.5.0.csv,661,1182,589,0.89107413,14,1,574,0,15,574
IND-JLMIV+R-2020,dataset/original//IND-JLMIV+R-2020/deltaspike/deltaspike-1.5.0.csv,dataset/original//IND-JLMIV+R-2020/deltaspike/deltaspike-1.6.0.csv,693,1166,576,0.831168831,9,0,566,1,9,567
IND-JLMIV+R-2020,dataset/original//IND-JLMIV+R-2020/deltaspike/deltaspike-1.6.0.csv,dataset/original//IND-JLMIV+R-2020/deltaspike/deltaspike-1.7.0.csv,708,1304,645,0.911016949,9,0,636,0,9,636
IND-JLMIV+R-2020,dataset/original//IND-JLMIV+R-2020/deltaspike/deltaspike-1.7.0.csv,dataset/original//IND-JLMIV+R-2020/deltaspike/deltaspike-1.8.0.csv,725,1316,667,0.92,3,2,662,0,5,662
IND-JLMIV+R-2020,dataset/original//IND-JLMIV+R-2020/eagle/eagle-0.3.0.csv,dataset/original//IND-JLMIV+R-2020/eagle/eagle-0.4.0.csv,731,761,564,0.771545828,2,0,562,0,2,562
IND-JLMIV+R-2020,dataset/original//IND-JLMIV+R-2020/eagle/eagle-0.4.0.csv,dataset/original//IND-JLMIV+R-2020/eagle/eagle-0.5.0.csv,118,397,0,0,0,0,0,0,0,0
IND-JLMIV+R-2020,dataset/original//IND-JLMIV+R-2020/giraph/giraph-0.1.0.csv,dataset/original//IND-JLMIV+R-2020/giraph/giraph-1.0.0.csv,431,5,0,0,0,0,0,0,0,0
IND-JLMIV+R-2020,dataset/original//IND-JLMIV+R-2020/giraph/giraph-1.0.0.csv,dataset/original//IND-JLMIV+R-2020/giraph/giraph-1.1.0.csv,753,154,134,0.177954847,0,0,134,0,0,134
IND-JLMIV+R-2020,dataset/original//IND-JLMIV+R-2020/gora/gora-0.1.csv,dataset/original//IND-JLMIV+R-2020/gora/gora-0.2.csv,104,74,55,0.528846154,3,0,52,0,3,52
IND-JLMIV+R-2020,dataset/original//IND-JLMIV+R-2020/gora/gora-0.2.csv,dataset/original//IND-JLMIV+R-2020/gora/gora-0.3.csv,132,74,46,0.348484848,0,0,46,0,0,46
IND-JLMIV+R-2020,dataset/original//IND-JLMIV+R-2020/gora/gora-0.3.csv,dataset/original//IND-JLMIV+R-2020/gora/gora-0.4.csv,146,81,66,0.452054795,1,0,65,0,1,65
IND-JLMIV+R-2020,dataset/original//IND-JLMIV+R-2020/gora/gora-0.4.csv,dataset/original//IND-JLMIV+R-2020/gora/gora-0.5.csv,169,175,129,0.763313609,5,0,124,0,5,124
IND-JLMIV+R-2020,dataset/original//IND-JLMIV+R-2020/gora/gora-0.5.csv,dataset/original//IND-JLMIV+R-2020/gora/gora-0.6.csv,170,214,151,0.888235294,8,0,143,0,8,143
IND-JLMIV+R-2020,dataset/original//IND-JLMIV+R-2020/gora/gora-0.6.csv,dataset/original//IND-JLMIV+R-2020/gora/gora-0.7.csv,201,82,66,0.328358209,0,0,66,0,0,66
IND-JLMIV+R-2020,dataset/original//IND-JLMIV+R-2020/gora/gora-0.7.csv,dataset/original//IND-JLMIV+R-2020/gora/gora-0.8.csv,210,252,165,0.785714286,0,0,165,0,0,165
IND-JLMIV+R-2020,dataset/original//IND-JLMIV+R-2020/jspwiki/jspwiki-1.4.0.csv,dataset/original//IND-JLMIV+R-2020/jspwiki/jspwiki-1.5.0.csv,13,11,8,0.615384615,0,0,8,0,0,8
IND-JLMIV+R-2020,dataset/original//IND-JLMIV+R-2020/jspwiki/jspwiki-1.5.0.csv,dataset/original//IND-JLMIV+R-2020/jspwiki/jspwiki-1.6.0.csv,14,7,6,0.428571429,0,0,6,0,0,6
IND-JLMIV+R-2020,dataset/original//IND-JLMIV+R-2020/jspwiki/jspwiki-1.6.0.csv,dataset/original//IND-JLMIV+R-2020/jspwiki/jspwiki-1.7.0.csv,34,4,4,0.117647059,0,0,4,0,0,4
IND-JLMIV+R-2020,dataset/original//IND-JLMIV+R-2020/jspwiki/jspwiki-1.7.0.csv,dataset/original//IND-JLMIV+R-2020/jspwiki/jspwiki-1.8.0.csv,39,26,18,0.461538462,0,0,18,0,0,18
IND-JLMIV+R-2020,dataset/original//IND-JLMIV+R-2020/jspwiki/jspwiki-1.8.0.csv,dataset/original//IND-JLMIV+R-2020/jspwiki/jspwiki-2.0.36.csv,103,13,11,0.106796117,0,0,11,0,0,11
IND-JLMIV+R-2020,dataset/original//IND-JLMIV+R-2020/jspwiki/jspwiki-2.0.36.csv,dataset/original//IND-JLMIV+R-2020/jspwiki/jspwiki-2.10.0.csv,351,0,0,0,0,0,0,0,0,0
IND-JLMIV+R-2020,dataset/original//IND-JLMIV+R-2020/jspwiki/jspwiki-2.10.0.csv,dataset/original//IND-JLMIV+R-2020/jspwiki/jspwiki-2.2.19.csv,218,1,0,0,0,0,0,0,0,0
IND-JLMIV+R-2020,dataset/original//IND-JLMIV+R-2020/jspwiki/jspwiki-2.2.19.csv,dataset/original//IND-JLMIV+R-2020/jspwiki/jspwiki-2.4.56.csv,307,42,24,0.078175896,0,0,24,0,0,24
IND-JLMIV+R-2020,dataset/original//IND-JLMIV+R-2020/jspwiki/jspwiki-2.4.56.csv,dataset/original//IND-JLMIV+R-2020/jspwiki/jspwiki-2.6.0.csv,364,163,119,0.326923077,0,1,118,0,1,118
IND-JLMIV+R-2020,dataset/original//IND-JLMIV+R-2020/jspwiki/jspwiki-2.6.0.csv,dataset/original//IND-JLMIV+R-2020/jspwiki/jspwiki-2.8.0.csv,730,432,147,0.201369863,0,0,147,0,0,147
IND-JLMIV+R-2020,dataset/original//IND-JLMIV+R-2020/jspwiki/jspwiki-2.8.0.csv,dataset/original//IND-JLMIV+R-2020/jspwiki/jspwiki-2.9.0.csv,372,35,1,0.002688172,0,0,1,0,0,1
IND-JLMIV+R-2020,dataset/original//IND-JLMIV+R-2020/knox/knox-0.10.0.csv,dataset/original//IND-JLMIV+R-2020/knox/knox-0.11.0.csv,648,804,570,0.87962963,16,1,553,0,17,553
IND-JLMIV+R-2020,dataset/original//IND-JLMIV+R-2020/knox/knox-0.11.0.csv,dataset/original//IND-JLMIV+R-2020/knox/knox-0.12.0.csv,670,811,547,0.81641791,12,0,535,0,12,535
IND-JLMIV+R-2020,dataset/original//IND-JLMIV+R-2020/knox/knox-0.12.0.csv,dataset/original//IND-JLMIV+R-2020/knox/knox-0.13.0.csv,683,769,544,0.796486091,4,0,540,0,4,540
IND-JLMIV+R-2020,dataset/original//IND-JLMIV+R-2020/knox/knox-0.13.0.csv,dataset/original//IND-JLMIV+R-2020/knox/knox-0.14.0.csv,738,811,584,0.791327913,2,0,582,0,2,582
IND-JLMIV+R-2020,dataset/original//IND-JLMIV+R-2020/knox/knox-0.14.0.csv,dataset/original//IND-JLMIV+R-2020/knox/knox-0.3.0.csv,388,228,187,0.481958763,0,0,187,0,0,187
IND-JLMIV+R-2020,dataset/original//IND-JLMIV+R-2020/knox/knox-0.3.0.csv,dataset/original//IND-JLMIV+R-2020/knox/knox-0.4.0.csv,444,425,325,0.731981982,24,0,301,0,24,301
IND-JLMIV+R-2020,dataset/original//IND-JLMIV+R-2020/knox/knox-0.4.0.csv,dataset/original//IND-JLMIV+R-2020/knox/knox-0.5.0.csv,496,494,378,0.762096774,6,14,358,0,20,358
IND-JLMIV+R-2020,dataset/original//IND-JLMIV+R-2020/knox/knox-0.5.0.csv,dataset/original//IND-JLMIV+R-2020/knox/knox-0.6.0.csv,542,567,430,0.793357934,38,13,379,0,51,379
IND-JLMIV+R-2020,dataset/original//IND-JLMIV+R-2020/knox/knox-0.6.0.csv,dataset/original//IND-JLMIV+R-2020/knox/knox-0.7.0.csv,590,547,418,0.708474576,3,9,406,0,12,406
IND-JLMIV+R-2020,dataset/original//IND-JLMIV+R-2020/knox/knox-0.7.0.csv,dataset/original//IND-JLMIV+R-2020/knox/knox-0.8.0.csv,594,755,561,0.944444444,27,0,534,0,27,534
IND-JLMIV+R-2020,dataset/original//IND-JLMIV+R-2020/knox/knox-0.8.0.csv,dataset/original//IND-JLMIV+R-2020/knox/knox-0.9.0.csv,609,674,517,0.848932677,14,0,503,0,14,503
IND-JLMIV+R-2020,dataset/original//IND-JLMIV+R-2020/knox/knox-0.9.0.csv,dataset/original//IND-JLMIV+R-2020/knox/knox-1.0.0.csv,762,11,0,0,0,0,0,0,0,0
IND-JLMIV+R-2020,dataset/original//IND-JLMIV+R-2020/kylin/kylin-0.6.1.csv,dataset/original//IND-JLMIV+R-2020/kylin/kylin-0.7.1.csv,489,1,0,0,0,0,0,0,0,0
IND-JLMIV+R-2020,dataset/original//IND-JLMIV+R-2020/kylin/kylin-0.7.1.csv,dataset/original//IND-JLMIV+R-2020/kylin/kylin-1.0.0.csv,505,297,39,0.077227723,0,0,39,0,0,39
IND-JLMIV+R-2020,dataset/original//IND-JLMIV+R-2020/kylin/kylin-1.0.0.csv,dataset/original//IND-JLMIV+R-2020/kylin/kylin-1.1.0.csv,504,686,124,0.246031746,0,1,123,0,1,123
IND-JLMIV+R-2020,dataset/original//IND-JLMIV+R-2020/kylin/kylin-1.1.0.csv,dataset/original//IND-JLMIV+R-2020/kylin/kylin-1.2.0.csv,514,668,131,0.254863813,1,0,130,0,1,130
IND-JLMIV+R-2020,dataset/original//IND-JLMIV+R-2020/kylin/kylin-1.2.0.csv,dataset/original//IND-JLMIV+R-2020/kylin/kylin-1.3.0.csv,530,517,104,0.196226415,0,0,104,0,0,104
IND-JLMIV+R-2020,dataset/original//IND-JLMIV+R-2020/kylin/kylin-1.3.0.csv,dataset/original//IND-JLMIV+R-2020/kylin/kylin-1.5.0.csv,739,184,65,0.087956698,0,3,62,0,3,62
IND-JLMIV+R-2020,dataset/original//IND-JLMIV+R-2020/kylin/kylin-1.5.0.csv,dataset/original//IND-JLMIV+R-2020/kylin/kylin-1.6.0.csv,790,411,212,0.26835443,6,0,206,0,6,206
IND-JLMIV+R-2020,dataset/original//IND-JLMIV+R-2020/kylin/kylin-1.6.0.csv,dataset/original//IND-JLMIV+R-2020/kylin/kylin-2.0.0.csv,856,508,316,0.369158879,4,0,311,1,4,312
IND-JLMIV+R-2020,dataset/original//IND-JLMIV+R-2020/kylin/kylin-2.0.0.csv,dataset/original//IND-JLMIV+R-2020/kylin/kylin-2.1.0.csv,936,877,580,0.61965812,9,15,556,0,24,556
IND-JLMIV+R-2020,dataset/original//IND-JLMIV+R-2020/kylin/kylin-2.1.0.csv,dataset/original//IND-JLMIV+R-2020/kylin/kylin-2.2.0.csv,1003,933,619,0.617148554,18,3,596,2,21,598
IND-JLMIV+R-2020,dataset/original//IND-JLMIV+R-2020/lens/lens-2.6.0.csv,dataset/original//IND-JLMIV+R-2020/lens/lens-2.7.0.csv,201,281,89,0.44278607,0,0,89,0,0,89
IND-JLMIV+R-2020,dataset/original//IND-JLMIV+R-2020/mahout/mahout-0.1.csv,dataset/original//IND-JLMIV+R-2020/mahout/mahout-0.10.0.csv,823,7,0,0,0,0,0,0,0,0
IND-JLMIV+R-2020,dataset/original//IND-JLMIV+R-2020/mahout/mahout-0.10.0.csv,dataset/original//IND-JLMIV+R-2020/mahout/mahout-0.11.0.csv,829,1149,770,0.928829916,3,0,767,0,3,767
IND-JLMIV+R-2020,dataset/original//IND-JLMIV+R-2020/mahout/mahout-0.11.0.csv,dataset/original//IND-JLMIV+R-2020/mahout/mahout-0.12.0.csv,810,1105,743,0.917283951,1,0,742,0,1,742
IND-JLMIV+R-2020,dataset/original//IND-JLMIV+R-2020/mahout/mahout-0.12.0.csv,dataset/original//IND-JLMIV+R-2020/mahout/mahout-0.13.0.csv,814,1086,753,0.925061425,0,0,753,0,0,753
IND-JLMIV+R-2020,dataset/original//IND-JLMIV+R-2020/mahout/mahout-0.13.0.csv,dataset/original//IND-JLMIV+R-2020/mahout/mahout-0.2.csv,425,18,0,0,0,0,0,0,0,0
IND-JLMIV+R-2020,dataset/original//IND-JLMIV+R-2020/mahout/mahout-0.2.csv,dataset/original//IND-JLMIV+R-2020/mahout/mahout-0.3.csv,699,133,75,0.107296137,1,1,73,0,2,73
IND-JLMIV+R-2020,dataset/original//IND-JLMIV+R-2020/mahout/mahout-0.3.csv,dataset/original//IND-JLMIV+R-2020/mahout/mahout-0.4.csv,763,182,150,0.196592398,2,5,143,0,7,143
IND-JLMIV+R-2020,dataset/original//IND-JLMIV+R-2020/mahout/mahout-0.4.csv,dataset/original//IND-JLMIV+R-2020/mahout/mahout-0.5.csv,777,466,275,0.353925354,2,11,262,0,13,262
IND-JLMIV+R-2020,dataset/original//IND-JLMIV+R-2020/mahout/mahout-0.5.csv,dataset/original//IND-JLMIV+R-2020/mahout/mahout-0.6.csv,893,456,279,0.312430011,1,0,278,0,1,278
IND-JLMIV+R-2020,dataset/original//IND-JLMIV+R-2020/mahout/mahout-0.6.csv,dataset/original//IND-JLMIV+R-2020/mahout/mahout-0.7.csv,834,926,623,0.747002398,22,0,601,0,22,601
IND-JLMIV+R-2020,dataset/original//IND-JLMIV+R-2020/mahout/mahout-0.7.csv,dataset/original//IND-JLMIV+R-2020/mahout/mahout-0.8.csv,906,521,350,0.386313466,1,0,349,0,1,349
IND-JLMIV+R-2020,dataset/original//IND-JLMIV+R-2020/mahout/mahout-0.8.csv,dataset/original//IND-JLMIV+R-2020/mahout/mahout-0.9.csv,836,912,635,0.759569378,7,1,627,0,8,627
IND-JLMIV+R-2020,dataset/original//IND-JLMIV+R-2020/manifoldcf/manifoldcf-0.1.csv,dataset/original//IND-JLMIV+R-2020/manifoldcf/manifoldcf-0.2.csv,433,490,363,0.838337182,13,3,342,5,16,347
IND-JLMIV+R-2020,dataset/original//IND-JLMIV+R-2020/manifoldcf/manifoldcf-0.2.csv,dataset/original//IND-JLMIV+R-2020/manifoldcf/manifoldcf-0.3.csv,492,395,275,0.558943089,8,0,267,0,8,267
IND-JLMIV+R-2020,dataset/original//IND-JLMIV+R-2020/manifoldcf/manifoldcf-0.3.csv,dataset/original//IND-JLMIV+R-2020/manifoldcf/manifoldcf-0.4.csv,513,434,408,0.795321637,16,0,392,0,16,392
IND-JLMIV+R-2020,dataset/original//IND-JLMIV+R-2020/manifoldcf/manifoldcf-0.4.csv,dataset/original//IND-JLMIV+R-2020/manifoldcf/manifoldcf-0.5.csv,546,439,413,0.756410256,15,0,398,0,15,398
IND-JLMIV+R-2020,dataset/original//IND-JLMIV+R-2020/manifoldcf/manifoldcf-0.5.csv,dataset/original//IND-JLMIV+R-2020/manifoldcf/manifoldcf-0.6.csv,632,529,441,0.69778481,18,3,420,0,21,420
IND-JLMIV+R-2020,dataset/original//IND-JLMIV+R-2020/manifoldcf/manifoldcf-0.6.csv,dataset/original//IND-JLMIV+R-2020/manifoldcf/manifoldcf-1.0.csv,640,616,534,0.834375,43,0,491,0,43,491
IND-JLMIV+R-2020,dataset/original//IND-JLMIV+R-2020/manifoldcf/manifoldcf-1.0.csv,dataset/original//IND-JLMIV+R-2020/manifoldcf/manifoldcf-1.1.csv,647,589,507,0.783616692,35,0,472,0,35,472
IND-JLMIV+R-2020,dataset/original//IND-JLMIV+R-2020/manifoldcf/manifoldcf-1.1.csv,dataset/original//IND-JLMIV+R-2020/manifoldcf/manifoldcf-1.10.csv,999,319,278,0.278278278,2,0,276,0,2,276
IND-JLMIV+R-2020,dataset/original//IND-JLMIV+R-2020/manifoldcf/manifoldcf-1.10.csv,dataset/original//IND-JLMIV+R-2020/manifoldcf/manifoldcf-1.2.csv,688,367,328,0.476744186,2,0,326,0,2,326
IND-JLMIV+R-2020,dataset/original//IND-JLMIV+R-2020/manifoldcf/manifoldcf-1.2.csv,dataset/original//IND-JLMIV+R-2020/manifoldcf/manifoldcf-1.3.csv,771,668,561,0.727626459,41,0,520,0,41,520
IND-JLMIV+R-2020,dataset/original//IND-JLMIV+R-2020/manifoldcf/manifoldcf-1.3.csv,dataset/original//IND-JLMIV+R-2020/manifoldcf/manifoldcf-1.4.csv,780,710,586,0.751282051,22,4,560,0,26,560
IND-JLMIV+R-2020,dataset/original//IND-JLMIV+R-2020/manifoldcf/manifoldcf-1.4.csv,dataset/original//IND-JLMIV+R-2020/manifoldcf/manifoldcf-1.5.csv,862,697,569,0.660092807,10,0,559,0,10,559
IND-JLMIV+R-2020,dataset/original//IND-JLMIV+R-2020/manifoldcf/manifoldcf-1.5.csv,dataset/original//IND-JLMIV+R-2020/manifoldcf/manifoldcf-1.6.csv,863,805,705,0.816917729,14,1,690,0,15,690
IND-JLMIV+R-2020,dataset/original//IND-JLMIV+R-2020/manifoldcf/manifoldcf-1.6.csv,dataset/original//IND-JLMIV+R-2020/manifoldcf/manifoldcf-1.7.csv,928,783,644,0.693965517,12,0,632,0,12,632
IND-JLMIV+R-2020,dataset/original//IND-JLMIV+R-2020/manifoldcf/manifoldcf-1.7.csv,dataset/original//IND-JLMIV+R-2020/manifoldcf/manifoldcf-1.8.csv,942,862,721,0.765392781,13,0,708,0,13,708
IND-JLMIV+R-2020,dataset/original//IND-JLMIV+R-2020/manifoldcf/manifoldcf-1.8.csv,dataset/original//IND-JLMIV+R-2020/manifoldcf/manifoldcf-1.9.csv,978,964,791,0.808793456,14,0,777,0,14,777
IND-JLMIV+R-2020,dataset/original//IND-JLMIV+R-2020/manifoldcf/manifoldcf-1.9.csv,dataset/original//IND-JLMIV+R-2020/manifoldcf/manifoldcf-2.0.csv,933,804,666,0.713826367,9,3,654,0,12,654
IND-JLMIV+R-2020,dataset/original//IND-JLMIV+R-2020/manifoldcf/manifoldcf-2.0.csv,dataset/original//IND-JLMIV+R-2020/manifoldcf/manifoldcf-2.1.csv,969,937,779,0.803921569,20,0,759,0,20,759
IND-JLMIV+R-2020,dataset/original//IND-JLMIV+R-2020/manifoldcf/manifoldcf-2.1.csv,dataset/original//IND-JLMIV+R-2020/manifoldcf/manifoldcf-2.10.csv,1058,878,739,0.698487713,3,0,736,0,3,736
IND-JLMIV+R-2020,dataset/original//IND-JLMIV+R-2020/manifoldcf/manifoldcf-2.10.csv,dataset/original//IND-JLMIV+R-2020/manifoldcf/manifoldcf-2.2.csv,995,932,786,0.789949749,3,0,783,0,3,783
IND-JLMIV+R-2020,dataset/original//IND-JLMIV+R-2020/manifoldcf/manifoldcf-2.2.csv,dataset/original//IND-JLMIV+R-2020/manifoldcf/manifoldcf-2.3.csv,1017,1028,855,0.840707965,16,1,838,0,17,838
IND-JLMIV+R-2020,dataset/original//IND-JLMIV+R-2020/manifoldcf/manifoldcf-2.3.csv,dataset/original//IND-JLMIV+R-2020/manifoldcf/manifoldcf-2.4.csv,1020,1086,891,0.873529412,25,0,865,1,25,866
IND-JLMIV+R-2020,dataset/original//IND-JLMIV+R-2020/manifoldcf/manifoldcf-2.4.csv,dataset/original//IND-JLMIV+R-2020/manifoldcf/manifoldcf-2.5.csv,1021,1044,855,0.8374143,16,0,839,0,16,839
IND-JLMIV+R-2020,dataset/original//IND-JLMIV+R-2020/manifoldcf/manifoldcf-2.5.csv,dataset/original//IND-JLMIV+R-2020/manifoldcf/manifoldcf-2.6.csv,1026,1101,904,0.881091618,20,0,884,0,20,884
IND-JLMIV+R-2020,dataset/original//IND-JLMIV+R-2020/manifoldcf/manifoldcf-2.6.csv,dataset/original//IND-JLMIV+R-2020/manifoldcf/manifoldcf-2.7.csv,1026,1059,877,0.854775828,8,0,869,0,8,869
IND-JLMIV+R-2020,dataset/original//IND-JLMIV+R-2020/manifoldcf/manifoldcf-2.7.csv,dataset/original//IND-JLMIV+R-2020/manifoldcf/manifoldcf-2.8.csv,1041,1166,892,0.856868396,9,8,875,0,17,875
IND-JLMIV+R-2020,dataset/original//IND-JLMIV+R-2020/manifoldcf/manifoldcf-2.8.csv,dataset/original//IND-JLMIV+R-2020/manifoldcf/manifoldcf-2.9.csv,1047,1188,904,0.863419293,5,0,899,0,5,899
IND-JLMIV+R-2020,dataset/original//IND-JLMIV+R-2020/nutch/nutch-0.7.csv,dataset/original//IND-JLMIV+R-2020/nutch/nutch-0.8.csv,319,71,45,0.141065831,0,0,45,0,0,45
IND-JLMIV+R-2020,dataset/original//IND-JLMIV+R-2020/nutch/nutch-0.8.csv,dataset/original//IND-JLMIV+R-2020/nutch/nutch-0.9.csv,332,288,222,0.668674699,6,0,216,0,6,216
IND-JLMIV+R-2020,dataset/original//IND-JLMIV+R-2020/nutch/nutch-0.9.csv,dataset/original//IND-JLMIV+R-2020/nutch/nutch-1.0.csv,358,396,119,0.332402235,1,0,118,0,1,118
IND-JLMIV+R-2020,dataset/original//IND-JLMIV+R-2020/nutch/nutch-1.0.csv,dataset/original//IND-JLMIV+R-2020/nutch/nutch-1.1.csv,364,609,286,0.785714286,15,0,271,0,15,271
IND-JLMIV+R-2020,dataset/original//IND-JLMIV+R-2020/nutch/nutch-1.1.csv,dataset/original//IND-JLMIV+R-2020/nutch/nutch-1.10.csv,284,74,61,0.214788732,0,0,61,0,0,61
IND-JLMIV+R-2020,dataset/original//IND-JLMIV+R-2020/nutch/nutch-1.10.csv,dataset/original//IND-JLMIV+R-2020/nutch/nutch-1.11.csv,382,298,209,0.547120419,4,1,204,0,5,204
IND-JLMIV+R-2020,dataset/original//IND-JLMIV+R-2020/nutch/nutch-1.11.csv,dataset/original//IND-JLMIV+R-2020/nutch/nutch-1.12.csv,397,432,317,0.798488665,7,4,306,0,11,306
IND-JLMIV+R-2020,dataset/original//IND-JLMIV+R-2020/nutch/nutch-1.12.csv,dataset/original//IND-JLMIV+R-2020/nutch/nutch-1.13.csv,404,287,178,0.440594059,4,0,174,0,4,174
IND-JLMIV+R-2020,dataset/original//IND-JLMIV+R-2020/nutch/nutch-1.13.csv,dataset/original//IND-JLMIV+R-2020/nutch/nutch-1.14.csv,413,438,317,0.767554479,2,0,315,0,2,315
IND-JLMIV+R-2020,dataset/original//IND-JLMIV+R-2020/nutch/nutch-1.14.csv,dataset/original//IND-JLMIV+R-2020/nutch/nutch-1.2.csv,371,67,53,0.142857143,0,0,52,1,0,53
IND-JLMIV+R-2020,dataset/original//IND-JLMIV+R-2020/nutch/nutch-1.2.csv,dataset/original//IND-JLMIV+R-2020/nutch/nutch-1.3.csv,245,250,187,0.763265306,17,0,170,0,17,170
IND-JLMIV+R-2020,dataset/original//IND-JLMIV+R-2020/nutch/nutch-1.3.csv,dataset/original//IND-JLMIV+R-2020/nutch/nutch-1.4.csv,246,185,124,0.504065041,1,1,122,0,2,122
IND-JLMIV+R-2020,dataset/original//IND-JLMIV+R-2020/nutch/nutch-1.4.csv,dataset/original//IND-JLMIV+R-2020/nutch/nutch-1.5.csv,249,247,179,0.718875502,13,2,164,0,15,164
IND-JLMIV+R-2020,dataset/original//IND-JLMIV+R-2020/nutch/nutch-1.5.csv,dataset/original//IND-JLMIV+R-2020/nutch/nutch-1.6.csv,250,274,202,0.808,16,0,186,0,16,186
IND-JLMIV+R-2020,dataset/original//IND-JLMIV+R-2020/nutch/nutch-1.6.csv,dataset/original//IND-JLMIV+R-2020/nutch/nutch-1.7.csv,254,215,150,0.590551181,5,0,145,0,5,145
IND-JLMIV+R-2020,dataset/original//IND-JLMIV+R-2020/nutch/nutch-1.7.csv,dataset/original//IND-JLMIV+R-2020/nutch/nutch-1.8.csv,256,274,195,0.76171875,3,0,189,3,3,192
IND-JLMIV+R-2020,dataset/original//IND-JLMIV+R-2020/nutch/nutch-1.8.csv,dataset/original//IND-JLMIV+R-2020/nutch/nutch-1.9.csv,246,237,211,0.857723577,4,0,207,0,4,207
IND-JLMIV+R-2020,dataset/original//IND-JLMIV+R-2020/nutch/nutch-1.9.csv,dataset/original//IND-JLMIV+R-2020/nutch/nutch-2.0.csv,500,148,56,0.112,0,0,56,0,0,56
IND-JLMIV+R-2020,dataset/original//IND-JLMIV+R-2020/nutch/nutch-2.0.csv,dataset/original//IND-JLMIV+R-2020/nutch/nutch-2.1.csv,252,273,206,0.817460317,10,0,195,1,10,196
IND-JLMIV+R-2020,dataset/original//IND-JLMIV+R-2020/nutch/nutch-2.1.csv,dataset/original//IND-JLMIV+R-2020/nutch/nutch-2.2.csv,255,191,168,0.658823529,8,10,150,0,18,150
IND-JLMIV+R-2020,dataset/original//IND-JLMIV+R-2020/nutch/nutch-2.2.csv,dataset/original//IND-JLMIV+R-2020/nutch/nutch-2.3.csv,323,196,144,0.445820433,0,0,144,0,0,144
IND-JLMIV+R-2020,dataset/original//IND-JLMIV+R-2020/opennlp/opennlp-1.7.0.csv,dataset/original//IND-JLMIV+R-2020/opennlp/opennlp-1.8.0.csv,626,311,302,0.482428115,0,0,302,0,0,302
IND-JLMIV+R-2020,dataset/original//IND-JLMIV+R-2020/parquet-mr/parquet-mr-1.0.0.csv,dataset/original//IND-JLMIV+R-2020/parquet-mr/parquet-mr-1.1.0.csv,224,227,170,0.758928571,2,0,168,0,2,168
IND-JLMIV+R-2020,dataset/original//IND-JLMIV+R-2020/parquet-mr/parquet-mr-1.1.0.csv,dataset/original//IND-JLMIV+R-2020/parquet-mr/parquet-mr-1.2.0.csv,236,263,191,0.809322034,1,0,190,0,1,190
IND-JLMIV+R-2020,dataset/original//IND-JLMIV+R-2020/parquet-mr/parquet-mr-1.2.0.csv,dataset/original//IND-JLMIV+R-2020/parquet-mr/parquet-mr-1.3.0.csv,274,204,146,0.532846715,1,0,145,0,1,145
IND-JLMIV+R-2020,dataset/original//IND-JLMIV+R-2020/parquet-mr/parquet-mr-1.3.0.csv,dataset/original//IND-JLMIV+R-2020/parquet-mr/parquet-mr-1.4.0.csv,309,283,204,0.660194175,6,0,198,0,6,198
IND-JLMIV+R-2020,dataset/original//IND-JLMIV+R-2020/parquet-mr/parquet-mr-1.4.0.csv,dataset/original//IND-JLMIV+R-2020/parquet-mr/parquet-mr-1.5.0.csv,323,366,264,0.817337461,11,1,252,0,12,252
IND-JLMIV+R-2020,dataset/original//IND-JLMIV+R-2020/parquet-mr/parquet-mr-1.5.0.csv,dataset/original//IND-JLMIV+R-2020/parquet-mr/parquet-mr-1.6.0.csv,377,262,197,0.522546419,2,0,195,0,2,195
IND-JLMIV+R-2020,dataset/original//IND-JLMIV+R-2020/parquet-mr/parquet-mr-1.6.0.csv,dataset/original//IND-JLMIV+R-2020/parquet-mr/parquet-mr-1.7.0.csv,377,17,0,0,0,0,0,0,0,0
IND-JLMIV+R-2020,dataset/original//IND-JLMIV+R-2020/santuario-java/santuario-java-1.0.0.csv,dataset/original//IND-JLMIV+R-2020/santuario-java/santuario-java-1.2.0.csv,121,2,1,0.008264463,0,0,1,0,0,1
IND-JLMIV+R-2020,dataset/original//IND-JLMIV+R-2020/santuario-java/santuario-java-1.2.0.csv,dataset/original//IND-JLMIV+R-2020/santuario-java/santuario-java-1.4.5.csv,257,85,22,0.085603113,0,0,22,0,0,22
IND-JLMIV+R-2020,dataset/original//IND-JLMIV+R-2020/santuario-java/santuario-java-1.4.5.csv,dataset/original//IND-JLMIV+R-2020/santuario-java/santuario-java-2.0.0.csv,389,57,20,0.051413882,0,0,20,0,0,20
IND-JLMIV+R-2020,dataset/original//IND-JLMIV+R-2020/santuario-java/santuario-java-2.0.0.csv,dataset/original//IND-JLMIV+R-2020/santuario-java/santuario-java-2.1.0.csv,463,203,0,0,0,0,0,0,0,0
IND-JLMIV+R-2020,dataset/original//IND-JLMIV+R-2020/systemml/systemml-0.10.csv,dataset/original//IND-JLMIV+R-2020/systemml/systemml-0.11.csv,973,1003,645,0.662898253,24,3,618,0,27,618
IND-JLMIV+R-2020,dataset/original//IND-JLMIV+R-2020/systemml/systemml-0.11.csv,dataset/original//IND-JLMIV+R-2020/systemml/systemml-0.12.csv,964,1136,721,0.747925311,48,1,672,0,49,672
IND-JLMIV+R-2020,dataset/original//IND-JLMIV+R-2020/systemml/systemml-0.12.csv,dataset/original//IND-JLMIV+R-2020/systemml/systemml-0.13.csv,971,1190,791,0.814624099,43,0,748,0,43,748
IND-JLMIV+R-2020,dataset/original//IND-JLMIV+R-2020/systemml/systemml-0.13.csv,dataset/original//IND-JLMIV+R-2020/systemml/systemml-0.14.csv,1008,1063,633,0.62797619,25,0,608,0,25,608
IND-JLMIV+R-2020,dataset/original//IND-JLMIV+R-2020/systemml/systemml-0.14.csv,dataset/original//IND-JLMIV+R-2020/systemml/systemml-0.15.csv,1029,899,487,0.473275024,5,1,481,0,6,481
IND-JLMIV+R-2020,dataset/original//IND-JLMIV+R-2020/systemml/systemml-0.15.csv,dataset/original//IND-JLMIV+R-2020/systemml/systemml-0.9.csv,851,425,154,0.180963572,0,0,154,0,0,154
IND-JLMIV+R-2020,dataset/original//IND-JLMIV+R-2020/systemml/systemml-0.9.csv,dataset/original//IND-JLMIV+R-2020/systemml/systemml-1.0.0.csv,1042,314,76,0.07293666,0,0,76,0,0,76
IND-JLMIV+R-2020,dataset/original//IND-JLMIV+R-2020/systemml/systemml-1.0.0.csv,dataset/original//IND-JLMIV+R-2020/systemml/systemml-1.1.0.csv,1035,1116,591,0.571014493,9,1,581,0,10,581
IND-JLMIV+R-2020,dataset/original//IND-JLMIV+R-2020/systemml/systemml-1.1.0.csv,dataset/original//IND-JLMIV+R-2020/systemml/systemml-1.2.0.csv,1073,912,380,0.354147251,0,0,380,0,0,380
IND-JLMIV+R-2020,dataset/original//IND-JLMIV+R-2020/tika/tika-0.1.csv,dataset/original//IND-JLMIV+R-2020/tika/tika-0.10.csv,269,6,0,0,0,0,0,0,0,0
IND-JLMIV+R-2020,dataset/original//IND-JLMIV+R-2020/tika/tika-0.10.csv,dataset/original//IND-JLMIV+R-2020/tika/tika-0.2.csv,101,24,19,0.188118812,0,0,19,0,0,19
IND-JLMIV+R-2020,dataset/original//IND-JLMIV+R-2020/tika/tika-0.2.csv,dataset/original//IND-JLMIV+R-2020/tika/tika-0.3.csv,119,100,10,0.084033613,0,0,10,0,0,10
IND-JLMIV+R-2020,dataset/original//IND-JLMIV+R-2020/tika/tika-0.3.csv,dataset/original//IND-JLMIV+R-2020/tika/tika-0.4.csv,135,99,0,0,0,0,0,0,0,0
IND-JLMIV+R-2020,dataset/original//IND-JLMIV+R-2020/tika/tika-0.4.csv,dataset/original//IND-JLMIV+R-2020/tika/tika-0.5.csv,146,116,80,0.547945205,4,0,76,0,4,76
IND-JLMIV+R-2020,dataset/original//IND-JLMIV+R-2020/tika/tika-0.5.csv,dataset/original//IND-JLMIV+R-2020/tika/tika-0.6.csv,149,169,121,0.812080537,7,0,114,0,7,114
IND-JLMIV+R-2020,dataset/original//IND-JLMIV+R-2020/tika/tika-0.6.csv,dataset/original//IND-JLMIV+R-2020/tika/tika-0.7.csv,159,144,93,0.58490566,9,0,84,0,9,84
IND-JLMIV+R-2020,dataset/original//IND-JLMIV+R-2020/tika/tika-0.7.csv,dataset/original//IND-JLMIV+R-2020/tika/tika-0.8.csv,200,120,86,0.43,4,3,79,0,7,79
IND-JLMIV+R-2020,dataset/original//IND-JLMIV+R-2020/tika/tika-0.8.csv,dataset/original//IND-JLMIV+R-2020/tika/tika-0.9.csv,222,206,146,0.657657658,14,5,127,0,19,127
IND-JLMIV+R-2020,dataset/original//IND-JLMIV+R-2020/tika/tika-0.9.csv,dataset/original//IND-JLMIV+R-2020/tika/tika-1.0.csv,269,154,114,0.423791822,11,1,102,0,12,102
IND-JLMIV+R-2020,dataset/original//IND-JLMIV+R-2020/tika/tika-1.0.csv,dataset/original//IND-JLMIV+R-2020/tika/tika-1.1.csv,275,298,198,0.72,16,1,181,0,17,181
IND-JLMIV+R-2020,dataset/original//IND-JLMIV+R-2020/tika/tika-1.1.csv,dataset/original//IND-JLMIV+R-2020/tika/tika-1.10.csv,473,135,118,0.249471459,1,0,115,2,1,117
IND-JLMIV+R-2020,dataset/original//IND-JLMIV+R-2020/tika/tika-1.10.csv,dataset/original//IND-JLMIV+R-2020/tika/tika-1.11.csv,479,493,344,0.718162839,10,3,331,0,13,331
IND-JLMIV+R-2020,dataset/original//IND-JLMIV+R-2020/tika/tika-1.11.csv,dataset/original//IND-JLMIV+R-2020/tika/tika-1.12.csv,488,737,463,0.948770492,23,1,439,0,24,439
IND-JLMIV+R-2020,dataset/original//IND-JLMIV+R-2020/tika/tika-1.12.csv,dataset/original//IND-JLMIV+R-2020/tika/tika-1.13.csv,506,662,414,0.818181818,16,0,398,0,16,398
IND-JLMIV+R-2020,dataset/original//IND-JLMIV+R-2020/tika/tika-1.13.csv,dataset/original//IND-JLMIV+R-2020/tika/tika-1.14.csv,538,712,437,0.812267658,11,0,426,0,11,426
IND-JLMIV+R-2020,dataset/original//IND-JLMIV+R-2020/tika/tika-1.14.csv,dataset/original//IND-JLMIV+R-2020/tika/tika-1.15.csv,636,673,406,0.63836478,8,0,398,0,8,398
IND-JLMIV+R-2020,dataset/original//IND-JLMIV+R-2020/tika/tika-1.15.csv,dataset/original//IND-JLMIV+R-2020/tika/tika-1.16.csv,642,915,584,0.909657321,12,0,572,0,12,572
IND-JLMIV+R-2020,dataset/original//IND-JLMIV+R-2020/tika/tika-1.16.csv,dataset/original//IND-JLMIV+R-2020/tika/tika-1.17.csv,651,893,572,0.878648233,10,0,562,0,10,562
IND-JLMIV+R-2020,dataset/original//IND-JLMIV+R-2020/tika/tika-1.17.csv,dataset/original//IND-JLMIV+R-2020/tika/tika-1.2.csv,307,139,122,0.397394137,1,2,119,0,3,119
IND-JLMIV+R-2020,dataset/original//IND-JLMIV+R-2020/tika/tika-1.2.csv,dataset/original//IND-JLMIV+R-2020/tika/tika-1.3.csv,311,369,262,0.84244373,21,0,240,1,21,241
IND-JLMIV+R-2020,dataset/original//IND-JLMIV+R-2020/tika/tika-1.3.csv,dataset/original//IND-JLMIV+R-2020/tika/tika-1.4.csv,318,414,285,0.896226415,26,1,258,0,27,258
IND-JLMIV+R-2020,dataset/original//IND-JLMIV+R-2020/tika/tika-1.4.csv,dataset/original//IND-JLMIV+R-2020/tika/tika-1.5.csv,321,310,279,0.869158879,13,0,264,2,13,266
IND-JLMIV+R-2020,dataset/original//IND-JLMIV+R-2020/tika/tika-1.5.csv,dataset/original//IND-JLMIV+R-2020/tika/tika-1.6.csv,344,378,261,0.75872093,15,0,246,0,15,246
IND-JLMIV+R-2020,dataset/original//IND-JLMIV+R-2020/tika/tika-1.6.csv,dataset/original//IND-JLMIV+R-2020/tika/tika-1.7.csv,363,368,252,0.694214876,12,0,240,0,12,240
IND-JLMIV+R-2020,dataset/original//IND-JLMIV+R-2020/tika/tika-1.7.csv,dataset/original//IND-JLMIV+R-2020/tika/tika-1.8.csv,436,390,271,0.621559633,10,0,261,0,10,261
IND-JLMIV+R-2020,dataset/original//IND-JLMIV+R-2020/tika/tika-1.8.csv,dataset/original//IND-JLMIV+R-2020/tika/tika-1.9.csv,464,581,380,0.818965517,14,1,365,0,15,365
IND-JLMIV+R-2020,dataset/original//IND-JLMIV+R-2020/wss4j/wss4j-1.5.0.csv,dataset/original//IND-JLMIV+R-2020/wss4j/wss4j-1.6.0.csv,135,1,0,0,0,0,0,0,0,0
IND-JLMIV+R-2020,dataset/original//IND-JLMIV+R-2020/wss4j/wss4j-1.6.0.csv,dataset/original//IND-JLMIV+R-2020/wss4j/wss4j-2.0.0.csv,482,0,0,0,0,0,0,0,0,0
IND-JLMIV+R-2020,dataset/original//IND-JLMIV+R-2020/wss4j/wss4j-2.0.0.csv,dataset/original//IND-JLMIV+R-2020/wss4j/wss4j-2.1.0.csv,493,303,247,0.501014199,2,0,245,0,2,245
IND-JLMIV+R-2020,dataset/original//IND-JLMIV+R-2020/wss4j/wss4j-2.1.0.csv,dataset/original//IND-JLMIV+R-2020/wss4j/wss4j-2.2.0.csv,500,139,128,0.256,0,0,128,0,0,128
JIRA-HA-2019,dataset/original//JIRA-HA-2019/activemq/activemq-5.0.0.csv,dataset/original//JIRA-HA-2019/activemq/activemq-5.1.0.csv,1970,1331,1291,0.655329949,21,41,1229,0,62,1229
JIRA-HA-2019,dataset/original//JIRA-HA-2019/activemq/activemq-5.1.0.csv,dataset/original//JIRA-HA-2019/activemq/activemq-5.2.0.csv,2040,1499,1428,0.7,15,65,1309,39,80,1348
JIRA-HA-2019,dataset/original//JIRA-HA-2019/activemq/activemq-5.2.0.csv,dataset/original//JIRA-HA-2019/activemq/activemq-5.3.0.csv,2367,1383,1350,0.570342205,29,13,1307,1,42,1308
JIRA-HA-2019,dataset/original//JIRA-HA-2019/activemq/activemq-5.3.0.csv,dataset/original//JIRA-HA-2019/activemq/activemq-5.8.0.csv,3420,853,101,0.029532164,0,1,100,0,1,100
JIRA-HA-2019,dataset/original//JIRA-HA-2019/camel/camel-1.4.0.csv,dataset/original//JIRA-HA-2019/camel/camel-2.10.0.csv,7914,100,98,0.012383119,0,0,96,2,0,98
JIRA-HA-2019,dataset/original//JIRA-HA-2019/camel/camel-2.10.0.csv,dataset/original//JIRA-HA-2019/camel/camel-2.11.0.csv,8846,6557,5716,0.646167759,50,51,5596,19,101,5615
JIRA-HA-2019,dataset/original//JIRA-HA-2019/camel/camel-2.11.0.csv,dataset/original//JIRA-HA-2019/camel/camel-2.9.0.csv,7120,4992,4154,0.583426966,0,0,4103,51,0,4154
JIRA-HA-2019,dataset/original//JIRA-HA-2019/derby/derby-10.2.1.6.csv,dataset/original//JIRA-HA-2019/derby/derby-10.3.1.4.csv,2206,1107,1089,0.493653672,6,22,1059,2,28,1061
JIRA-HA-2019,dataset/original//JIRA-HA-2019/derby/derby-10.3.1.4.csv,dataset/original//JIRA-HA-2019/derby/derby-10.5.1.1.csv,2705,1339,1320,0.487985213,0,31,1289,0,31,1289
JIRA-HA-2019,dataset/original//JIRA-HA-2019/groovy/groovy-1.5.7.csv,dataset/original//JIRA-HA-2019/groovy/groovy-1.6.BETA1.csv,821,629,611,0.744214373,25,6,567,13,31,580
JIRA-HA-2019,dataset/original//JIRA-HA-2019/groovy/groovy-1.6.BETA1.csv,dataset/original//JIRA-HA-2019/groovy/groovy-1.6.BETA2.csv,884,659,641,0.725113122,28,13,590,10,41,600
JIRA-HA-2019,dataset/original//JIRA-HA-2019/hbase/hbase-0.94.0.csv,dataset/original//JIRA-HA-2019/hbase/hbase-0.95.0.csv,1669,64,0,0,0,0,0,0,0,0
JIRA-HA-2019,dataset/original//JIRA-HA-2019/hbase/hbase-0.95.0.csv,dataset/original//JIRA-HA-2019/hbase/hbase-0.95.2.csv,1834,724,677,0.369138495,18,16,642,1,34,643
JIRA-HA-2019,dataset/original//JIRA-HA-2019/hive/hive-0.10.0.csv,dataset/original//JIRA-HA-2019/hive/hive-0.12.0.csv,2662,998,958,0.35987979,1,8,940,9,9,949
JIRA-HA-2019,dataset/original//JIRA-HA-2019/hive/hive-0.12.0.csv,dataset/original//JIRA-HA-2019/hive/hive-0.9.0.csv,1416,737,701,0.495056497,0,0,695,6,0,701
JIRA-HA-2019,dataset/original//JIRA-HA-2019/jruby/jruby-1.1.0.csv,dataset/original//JIRA-HA-2019/jruby/jruby-1.4.0.csv,978,147,128,0.130879346,0,6,122,0,6,122
JIRA-HA-2019,dataset/original//JIRA-HA-2019/jruby/jruby-1.4.0.csv,dataset/original//JIRA-HA-2019/jruby/jruby-1.5.0.csv,1131,625,612,0.541114058,24,52,519,17,76,536
JIRA-HA-2019,dataset/original//JIRA-HA-2019/jruby/jruby-1.5.0.csv,dataset/original//JIRA-HA-2019/jruby/jruby-1.7.0.preview1.csv,1614,401,391,0.242255266,0,8,382,1,8,383
JIRA-HA-2019,dataset/original//JIRA-HA-2019/lucene/lucene-2.3.0.csv,dataset/original//JIRA-HA-2019/lucene/lucene-2.9.0.csv,1368,264,221,0.161549708,0,9,210,2,9,212
JIRA-HA-2019,dataset/original//JIRA-HA-2019/lucene/lucene-2.9.0.csv,dataset/original//JIRA-HA-2019/lucene/lucene-3.0.0.csv,1337,364,324,0.242333583,11,0,311,2,11,313
JIRA-HA-2019,dataset/original//JIRA-HA-2019/lucene/lucene-3.0.0.csv,dataset/original//JIRA-HA-2019/lucene/lucene-3.1.0.csv,1831,615,516,0.281813217,39,29,436,12,68,448
JIRA-HA-2019,dataset/original//JIRA-HA-2019/wicket/wicket-1.3.0.beta1.csv,dataset/original//JIRA-HA-2019/wicket/wicket-1.3.0.beta2.csv,1763,1708,1119,0.634713556,141,0,978,0,141,978
JIRA-HA-2019,dataset/original//JIRA-HA-2019/wicket/wicket-1.3.0.beta2.csv,dataset/original//JIRA-HA-2019/wicket/wicket-1.5.3.0.csv,2578,594,4,0.00155159,0,0,4,0,0,4
JIRA-RA-2019,dataset/original//JIRA-RA-2019/activemq/activemq-5.0.0.csv,dataset/original//JIRA-RA-2019/activemq/activemq-5.1.0.csv,1970,1331,1293,0.656345178,27,36,1141,89,63,1230
JIRA-RA-2019,dataset/original//JIRA-RA-2019/activemq/activemq-5.1.0.csv,dataset/original//JIRA-RA-2019/activemq/activemq-5.2.0.csv,2040,1495,1425,0.698529412,13,90,1301,21,103,1322
JIRA-RA-2019,dataset/original//JIRA-RA-2019/activemq/activemq-5.2.0.csv,dataset/original//JIRA-RA-2019/activemq/activemq-5.3.0.csv,2367,1381,1348,0.569497254,12,65,1247,24,77,1271
JIRA-RA-2019,dataset/original//JIRA-RA-2019/activemq/activemq-5.3.0.csv,dataset/original//JIRA-RA-2019/activemq/activemq-5.8.0.csv,3420,851,101,0.029532164,0,2,96,3,2,99
JIRA-RA-2019,dataset/original//JIRA-RA-2019/camel/camel-1.4.0.csv,dataset/original//JIRA-RA-2019/camel/camel-2.10.0.csv,7914,99,97,0.01225676,0,0,95,2,0,97
JIRA-RA-2019,dataset/original//JIRA-RA-2019/camel/camel-2.10.0.csv,dataset/original//JIRA-RA-2019/camel/camel-2.11.0.csv,8846,6557,5716,0.646167759,0,55,5632,29,55,5661
JIRA-RA-2019,dataset/original//JIRA-RA-2019/camel/camel-2.11.0.csv,dataset/original//JIRA-RA-2019/camel/camel-2.9.0.csv,7120,4981,4143,0.581882022,0,10,4107,26,10,4133
JIRA-RA-2019,dataset/original//JIRA-RA-2019/derby/derby-10.2.1.6.csv,dataset/original//JIRA-RA-2019/derby/derby-10.3.1.4.csv,2206,1104,1086,0.492293744,100,29,862,95,129,957
JIRA-RA-2019,dataset/original//JIRA-RA-2019/derby/derby-10.3.1.4.csv,dataset/original//JIRA-RA-2019/derby/derby-10.5.1.1.csv,2705,1334,1315,0.486136784,41,16,1122,136,57,1258
JIRA-RA-2019,dataset/original//JIRA-RA-2019/groovy/groovy-1.5.7.csv,dataset/original//JIRA-RA-2019/groovy/groovy-1.6.BETA1.csv,821,628,610,0.742996346,3,7,595,5,10,600
JIRA-RA-2019,dataset/original//JIRA-RA-2019/groovy/groovy-1.6.BETA1.csv,dataset/original//JIRA-RA-2019/groovy/groovy-1.6.BETA2.csv,884,659,641,0.725113122,5,6,623,7,11,630
JIRA-RA-2019,dataset/original//JIRA-RA-2019/hbase/hbase-0.94.0.csv,dataset/original//JIRA-RA-2019/hbase/hbase-0.95.0.csv,1669,64,0,0,0,0,0,0,0,0
JIRA-RA-2019,dataset/original//JIRA-RA-2019/hbase/hbase-0.95.0.csv,dataset/original//JIRA-RA-2019/hbase/hbase-0.95.2.csv,1834,725,677,0.369138495,8,85,570,14,93,584
JIRA-RA-2019,dataset/original//JIRA-RA-2019/hive/hive-0.10.0.csv,dataset/original//JIRA-RA-2019/hive/hive-0.12.0.csv,2662,1000,960,0.360631104,1,3,930,26,4,956
JIRA-RA-2019,dataset/original//JIRA-RA-2019/hive/hive-0.12.0.csv,dataset/original//JIRA-RA-2019/hive/hive-0.9.0.csv,1416,738,702,0.495762712,0,27,674,1,27,675
JIRA-RA-2019,dataset/original//JIRA-RA-2019/jruby/jruby-1.1.0.csv,dataset/original//JIRA-RA-2019/jruby/jruby-1.4.0.csv,978,146,127,0.129856851,0,3,124,0,3,124
JIRA-RA-2019,dataset/original//JIRA-RA-2019/jruby/jruby-1.4.0.csv,dataset/original//JIRA-RA-2019/jruby/jruby-1.5.0.csv,1131,625,612,0.541114058,3,3,596,10,6,606
JIRA-RA-2019,dataset/original//JIRA-RA-2019/jruby/jruby-1.5.0.csv,dataset/original//JIRA-RA-2019/jruby/jruby-1.7.0.preview1.csv,1614,399,389,0.241016109,0,1,385,3,1,388
JIRA-RA-2019,dataset/original//JIRA-RA-2019/lucene/lucene-2.3.0.csv,dataset/original//JIRA-RA-2019/lucene/lucene-2.9.0.csv,1368,265,222,0.162280702,4,1,209,8,5,217
JIRA-RA-2019,dataset/original//JIRA-RA-2019/lucene/lucene-2.9.0.csv,dataset/original//JIRA-RA-2019/lucene/lucene-3.0.0.csv,1337,364,324,0.242333583,5,1,298,20,6,318
JIRA-RA-2019,dataset/original//JIRA-RA-2019/lucene/lucene-3.0.0.csv,dataset/original//JIRA-RA-2019/lucene/lucene-3.1.0.csv,1831,615,518,0.282905516,1,6,500,11,7,511
JIRA-RA-2019,dataset/original//JIRA-RA-2019/wicket/wicket-1.3.0.beta1.csv,dataset/original//JIRA-RA-2019/wicket/wicket-1.3.0.beta2.csv,1763,1701,1112,0.630743052,7,39,1062,4,46,1066
JIRA-RA-2019,dataset/original//JIRA-RA-2019/wicket/wicket-1.3.0.beta2.csv,dataset/original//JIRA-RA-2019/wicket/wicket-1.5.3.0.csv,2578,591,6,0.002327386,0,0,6,0,0,6
MA-SZZ-2020,dataset/original//MA-SZZ-2020/flume/flume-1.2.0.csv,dataset/original//MA-SZZ-2020/flume/flume-1.3.0.csv,370,208,182,0.491891892,41,0,141,0,41,141
MA-SZZ-2020,dataset/original//MA-SZZ-2020/flume/flume-1.3.0.csv,dataset/original//MA-SZZ-2020/flume/flume-1.3.1.csv,371,377,334,0.900269542,86,1,240,7,87,247
MA-SZZ-2020,dataset/original//MA-SZZ-2020/flume/flume-1.3.1.csv,dataset/original//MA-SZZ-2020/flume/flume-1.4.0.csv,453,260,228,0.503311258,38,0,190,0,38,190
MA-SZZ-2020,dataset/original//MA-SZZ-2020/flume/flume-1.4.0.csv,dataset/original//MA-SZZ-2020/flume/flume-1.5.0.csv,490,398,340,0.693877551,53,0,286,1,53,287
MA-SZZ-2020,dataset/original//MA-SZZ-2020/flume/flume-1.5.0.csv,dataset/original//MA-SZZ-2020/flume/flume-1.5.1.csv,490,539,477,0.973469388,72,1,371,33,73,404
MA-SZZ-2020,dataset/original//MA-SZZ-2020/flume/flume-1.5.1.csv,dataset/original//MA-SZZ-2020/flume/flume-1.5.2.csv,490,541,479,0.97755102,74,0,405,0,74,405
MA-SZZ-2020,dataset/original//MA-SZZ-2020/flume/flume-1.5.2.csv,dataset/original//MA-SZZ-2020/flume/flume-1.6.0.csv,546,423,361,0.661172161,29,0,332,0,29,332
MA-SZZ-2020,dataset/original//MA-SZZ-2020/flume/flume-1.6.0.csv,dataset/original//MA-SZZ-2020/flume/flume-1.7.0.csv,563,402,339,0.602131439,18,0,321,0,18,321
MA-SZZ-2020,dataset/original//MA-SZZ-2020/flume/flume-1.7.0.csv,dataset/original//MA-SZZ-2020/flume/flume-1.8.0.csv,574,549,478,0.832752613,10,0,468,0,10,468
MA-SZZ-2020,dataset/original//MA-SZZ-2020/mahout/mahout-0.10.0.csv,dataset/original//MA-SZZ-2020/mahout/mahout-0.11.0.csv,1157,1149,1071,0.925669836,165,0,906,0,165,906
MA-SZZ-2020,dataset/original//MA-SZZ-2020/mahout/mahout-0.11.0.csv,dataset/original//MA-SZZ-2020/mahout/mahout-0.12.0.csv,1122,1106,1024,0.912655971,184,0,840,0,184,840
MA-SZZ-2020,dataset/original//MA-SZZ-2020/mahout/mahout-0.12.0.csv,dataset/original//MA-SZZ-2020/mahout/mahout-0.13.0.csv,1126,1085,1003,0.890763766,159,0,844,0,159,844
MA-SZZ-2020,dataset/original//MA-SZZ-2020/mahout/mahout-0.13.0.csv,dataset/original//MA-SZZ-2020/mahout/mahout-0.4.csv,1027,109,14,0.013631938,7,0,7,0,7,7
MA-SZZ-2020,dataset/original//MA-SZZ-2020/mahout/mahout-0.4.csv,dataset/original//MA-SZZ-2020/mahout/mahout-0.5.csv,1097,464,402,0.366453965,61,0,341,0,61,341
MA-SZZ-2020,dataset/original//MA-SZZ-2020/mahout/mahout-0.5.csv,dataset/original//MA-SZZ-2020/mahout/mahout-0.6.csv,1267,457,370,0.292028414,55,0,315,0,55,315
MA-SZZ-2020,dataset/original//MA-SZZ-2020/mahout/mahout-0.6.csv,dataset/original//MA-SZZ-2020/mahout/mahout-0.7.csv,1130,922,840,0.743362832,193,0,647,0,193,647
MA-SZZ-2020,dataset/original//MA-SZZ-2020/mahout/mahout-0.7.csv,dataset/original//MA-SZZ-2020/mahout/mahout-0.8.csv,1265,523,453,0.358102767,77,0,376,0,77,376
MA-SZZ-2020,dataset/original//MA-SZZ-2020/mahout/mahout-0.8.csv,dataset/original//MA-SZZ-2020/mahout/mahout-0.9.csv,1168,911,833,0.713184932,193,0,640,0,193,640
MA-SZZ-2020,dataset/original//MA-SZZ-2020/maven/maven-2.2.0.csv,dataset/original//MA-SZZ-2020/maven/maven-2.2.1.csv,323,311,251,0.777089783,9,0,240,2,9,242
MA-SZZ-2020,dataset/original//MA-SZZ-2020/maven/maven-2.2.1.csv,dataset/original//MA-SZZ-2020/maven/maven-3.0.0.csv,664,78,46,0.069277108,0,0,46,0,0,46
MA-SZZ-2020,dataset/original//MA-SZZ-2020/maven/maven-3.0.0.csv,dataset/original//MA-SZZ-2020/maven/maven-3.0.1.csv,667,713,553,0.829085457,62,0,491,0,62,491
MA-SZZ-2020,dataset/original//MA-SZZ-2020/maven/maven-3.0.1.csv,dataset/original//MA-SZZ-2020/maven/maven-3.0.2.csv,678,705,550,0.81120944,57,0,493,0,57,493
MA-SZZ-2020,dataset/original//MA-SZZ-2020/maven/maven-3.0.2.csv,dataset/original//MA-SZZ-2020/maven/maven-3.0.3.csv,679,714,554,0.815905744,47,0,507,0,47,507
MA-SZZ-2020,dataset/original//MA-SZZ-2020/maven/maven-3.0.3.csv,dataset/original//MA-SZZ-2020/maven/maven-3.0.4.csv,681,724,559,0.820851689,47,0,512,0,47,512
MA-SZZ-2020,dataset/original//MA-SZZ-2020/maven/maven-3.0.4.csv,dataset/original//MA-SZZ-2020/maven/maven-3.0.5.csv,681,770,607,0.89133627,56,3,542,6,59,548
MA-SZZ-2020,dataset/original//MA-SZZ-2020/maven/maven-3.0.5.csv,dataset/original//MA-SZZ-2020/maven/maven-3.1.0.csv,702,553,419,0.596866097,16,0,403,0,16,403
MA-SZZ-2020,dataset/original//MA-SZZ-2020/maven/maven-3.1.0.csv,dataset/original//MA-SZZ-2020/maven/maven-3.1.1.csv,703,783,615,0.874822191,56,0,559,0,56,559
MA-SZZ-2020,dataset/original//MA-SZZ-2020/shiro/shiro-1.1.0.csv,dataset/original//MA-SZZ-2020/shiro/shiro-1.2.0.csv,463,388,311,0.671706263,10,0,301,0,10,301
MA-SZZ-2020,dataset/original//MA-SZZ-2020/shiro/shiro-1.2.0.csv,dataset/original//MA-SZZ-2020/shiro/shiro-1.2.1.csv,464,548,446,0.961206897,27,0,419,0,27,419
MA-SZZ-2020,dataset/original//MA-SZZ-2020/shiro/shiro-1.2.1.csv,dataset/original//MA-SZZ-2020/shiro/shiro-1.2.2.csv,465,548,446,0.959139785,16,0,429,1,16,430
MA-SZZ-2020,dataset/original//MA-SZZ-2020/shiro/shiro-1.2.2.csv,dataset/original//MA-SZZ-2020/shiro/shiro-1.2.3.csv,466,562,459,0.984978541,18,0,441,0,18,441
MA-SZZ-2020,dataset/original//MA-SZZ-2020/shiro/shiro-1.2.3.csv,dataset/original//MA-SZZ-2020/shiro/shiro-1.2.4.csv,466,555,452,0.969957082,15,0,437,0,15,437
MA-SZZ-2020,dataset/original//MA-SZZ-2020/shiro/shiro-1.2.4.csv,dataset/original//MA-SZZ-2020/shiro/shiro-1.2.5.csv,466,557,454,0.974248927,18,0,436,0,18,436
MA-SZZ-2020,dataset/original//MA-SZZ-2020/shiro/shiro-1.2.5.csv,dataset/original//MA-SZZ-2020/shiro/shiro-1.2.6.csv,466,565,462,0.991416309,18,0,444,0,18,444
MA-SZZ-2020,dataset/original//MA-SZZ-2020/shiro/shiro-1.2.6.csv,dataset/original//MA-SZZ-2020/shiro/shiro-1.3.0.csv,493,527,423,0.85801217,8,0,415,0,8,415
MA-SZZ-2020,dataset/original//MA-SZZ-2020/shiro/shiro-1.3.0.csv,dataset/original//MA-SZZ-2020/shiro/shiro-1.3.1.csv,493,596,486,0.985801217,16,0,470,0,16,470
MA-SZZ-2020,dataset/original//MA-SZZ-2020/zeppelin/zeppelin-0.5.0.csv,dataset/original//MA-SZZ-2020/zeppelin/zeppelin-0.5.5.csv,168,82,62,0.369047619,9,0,53,0,9,53
MA-SZZ-2020,dataset/original//MA-SZZ-2020/zeppelin/zeppelin-0.5.5.csv,dataset/original//MA-SZZ-2020/zeppelin/zeppelin-0.5.6.csv,188,171,117,0.622340426,20,1,92,4,21,96
MA-SZZ-2020,dataset/original//MA-SZZ-2020/zeppelin/zeppelin-0.5.6.csv,dataset/original//MA-SZZ-2020/zeppelin/zeppelin-0.6.0.csv,289,92,41,0.141868512,4,1,36,0,5,36
MA-SZZ-2020,dataset/original//MA-SZZ-2020/zeppelin/zeppelin-0.6.0.csv,dataset/original//MA-SZZ-2020/zeppelin/zeppelin-0.6.1.csv,293,355,240,0.819112628,66,3,165,6,69,171
MA-SZZ-2020,dataset/original//MA-SZZ-2020/zeppelin/zeppelin-0.6.1.csv,dataset/original//MA-SZZ-2020/zeppelin/zeppelin-0.6.2.csv,294,389,259,0.880952381,76,2,174,7,78,181
MA-SZZ-2020,dataset/original//MA-SZZ-2020/zeppelin/zeppelin-0.6.2.csv,dataset/original//MA-SZZ-2020/zeppelin/zeppelin-0.7.0.csv,409,155,90,0.2200489,12,2,76,0,14,76
MA-SZZ-2020,dataset/original//MA-SZZ-2020/zeppelin/zeppelin-0.7.0.csv,dataset/original//MA-SZZ-2020/zeppelin/zeppelin-0.7.1.csv,410,489,313,0.763414634,60,1,250,2,61,252
MA-SZZ-2020,dataset/original//MA-SZZ-2020/zeppelin/zeppelin-0.7.1.csv,dataset/original//MA-SZZ-2020/zeppelin/zeppelin-0.7.2.csv,411,532,353,0.858880779,64,3,285,1,67,286
MA-SZZ-2020,dataset/original//MA-SZZ-2020/zeppelin/zeppelin-0.7.2.csv,dataset/original//MA-SZZ-2020/zeppelin/zeppelin-0.7.3.csv,413,581,371,0.898305085,63,4,291,13,67,304
Metrics-Repo-2010,dataset/original//Metrics-Repo-2010/ant/ant-1.3.csv,dataset/original//Metrics-Repo-2010/ant/ant-1.4.csv,178,169,65,0.365168539,2,5,58,0,7,58
Metrics-Repo-2010,dataset/original//Metrics-Repo-2010/ant/ant-1.4.csv,dataset/original//Metrics-Repo-2010/ant/ant-1.5.csv,293,146,21,0.071672355,0,2,16,3,2,19
Metrics-Repo-2010,dataset/original//Metrics-Repo-2010/ant/ant-1.5.csv,dataset/original//Metrics-Repo-2010/ant/ant-1.6.csv,351,357,116,0.33048433,6,18,89,3,24,92
Metrics-Repo-2010,dataset/original//Metrics-Repo-2010/ant/ant-1.6.csv,dataset/original//Metrics-Repo-2010/ant/ant-1.7.csv,745,440,133,0.17852349,5,15,110,3,20,113
Metrics-Repo-2010,dataset/original//Metrics-Repo-2010/camel/camel-1.0.csv,dataset/original//Metrics-Repo-2010/camel/camel-1.2.csv,608,111,44,0.072368421,1,8,34,1,9,35
Metrics-Repo-2010,dataset/original//Metrics-Repo-2010/camel/camel-1.2.csv,dataset/original//Metrics-Repo-2010/camel/camel-1.4.csv,872,531,222,0.254587156,12,9,165,36,21,201
Metrics-Repo-2010,dataset/original//Metrics-Repo-2010/camel/camel-1.4.csv,dataset/original//Metrics-Repo-2010/camel/camel-1.6.csv,965,1401,522,0.540932642,21,66,421,14,87,435
Metrics-Repo-2010,dataset/original//Metrics-Repo-2010/forrest/forrest-0.6.csv,dataset/original//Metrics-Repo-2010/forrest/forrest-0.7.csv,29,173,4,0.137931034,0,1,3,0,1,3
Metrics-Repo-2010,dataset/original//Metrics-Repo-2010/forrest/forrest-0.7.csv,dataset/original//Metrics-Repo-2010/forrest/forrest-0.8.csv,32,187,19,0.59375,0,0,18,1,0,19
Metrics-Repo-2010,dataset/original//Metrics-Repo-2010/jedit/jedit-3.2.csv,dataset/original//Metrics-Repo-2010/jedit/jedit-4.0.csv,306,142,109,0.35620915,0,4,105,0,4,105
Metrics-Repo-2010,dataset/original//Metrics-Repo-2010/jedit/jedit-4.0.csv,dataset/original//Metrics-Repo-2010/jedit/jedit-4.1.csv,312,177,118,0.378205128,0,6,107,5,6,112
Metrics-Repo-2010,dataset/original//Metrics-Repo-2010/jedit/jedit-4.1.csv,dataset/original//Metrics-Repo-2010/jedit/jedit-4.2.csv,367,164,90,0.245231608,0,3,86,1,3,87
Metrics-Repo-2010,dataset/original//Metrics-Repo-2010/jedit/jedit-4.2.csv,dataset/original//Metrics-Repo-2010/jedit/jedit-4.3.csv,492,65,41,0.083333333,0,0,40,1,0,41
Metrics-Repo-2010,dataset/original//Metrics-Repo-2010/log4j/log4j-1.0.csv,dataset/original//Metrics-Repo-2010/log4j/log4j-1.1.csv,109,80,53,0.486238532,2,4,46,1,6,47
Metrics-Repo-2010,dataset/original//Metrics-Repo-2010/log4j/log4j-1.1.csv,dataset/original//Metrics-Repo-2010/log4j/log4j-1.2.csv,205,79,37,0.180487805,2,32,3,0,34,3
Metrics-Repo-2010,dataset/original//Metrics-Repo-2010/lucene/lucene-2.0.csv,dataset/original//Metrics-Repo-2010/lucene/lucene-2.2.csv,247,410,94,0.380566802,4,41,47,2,45,49
Metrics-Repo-2010,dataset/original//Metrics-Repo-2010/lucene/lucene-2.2.csv,dataset/original//Metrics-Repo-2010/lucene/lucene-2.4.csv,340,336,96,0.282352941,17,40,28,11,57,39
Metrics-Repo-2010,dataset/original//Metrics-Repo-2010/pbeans/pbeans-1.0.csv,dataset/original//Metrics-Repo-2010/pbeans/pbeans-2.0.csv,51,4,6,0.117647059,2,0,3,1,2,4
Metrics-Repo-2010,dataset/original//Metrics-Repo-2010/poi/poi-1.5.csv,dataset/original//Metrics-Repo-2010/poi/poi-2.0.csv,314,225,92,0.292993631,4,3,73,12,7,85
Metrics-Repo-2010,dataset/original//Metrics-Repo-2010/poi/poi-2.0.csv,dataset/original//Metrics-Repo-2010/poi/poi-2.5.csv,385,619,284,0.737662338,18,180,77,9,198,86
Metrics-Repo-2010,dataset/original//Metrics-Repo-2010/poi/poi-2.5.csv,dataset/original//Metrics-Repo-2010/poi/poi-3.0.csv,442,328,121,0.273755656,3,52,61,5,55,66
Metrics-Repo-2010,dataset/original//Metrics-Repo-2010/synapse/synapse-1.0.csv,dataset/original//Metrics-Repo-2010/synapse/synapse-1.1.csv,222,98,38,0.171171171,1,8,28,1,9,29
Metrics-Repo-2010,dataset/original//Metrics-Repo-2010/synapse/synapse-1.1.csv,dataset/original//Metrics-Repo-2010/synapse/synapse-1.2.csv,256,211,76,0.296875,1,11,64,0,12,64
Metrics-Repo-2010,dataset/original//Metrics-Repo-2010/velocity/velocity-1.4.csv,dataset/original//Metrics-Repo-2010/velocity/velocity-1.5.csv,214,40,27,0.126168224,5,0,1,21,5,22
Metrics-Repo-2010,dataset/original//Metrics-Repo-2010/velocity/velocity-1.5.csv,dataset/original//Metrics-Repo-2010/velocity/velocity-1.6.csv,229,183,94,0.410480349,10,4,46,34,14,80
Metrics-Repo-2010,dataset/original//Metrics-Repo-2010/xalan/xalan-2.4.csv,dataset/original//Metrics-Repo-2010/xalan/xalan-2.5.csv,803,112,111,0.138231631,3,49,59,0,52,59
Metrics-Repo-2010,dataset/original//Metrics-Repo-2010/xalan/xalan-2.5.csv,dataset/original//Metrics-Repo-2010/xalan/xalan-2.6.csv,885,597,526,0.594350282,114,78,224,110,192,334
Metrics-Repo-2010,dataset/original//Metrics-Repo-2010/xalan/xalan-2.6.csv,dataset/original//Metrics-Repo-2010/xalan/xalan-2.7.csv,909,505,348,0.382838284,61,284,3,0,345,3
Metrics-Repo-2010,dataset/original//Metrics-Repo-2010/xerces/xerces-0.init.csv,dataset/original//Metrics-Repo-2010/xerces/xerces-1.2.csv,440,59,40,0.090909091,12,1,15,12,13,27
Metrics-Repo-2010,dataset/original//Metrics-Repo-2010/xerces/xerces-1.2.csv,dataset/original//Metrics-Repo-2010/xerces/xerces-1.3.csv,453,398,284,0.626931567,2,23,234,25,25,259
Metrics-Repo-2010,dataset/original//Metrics-Repo-2010/xerces/xerces-1.3.csv,dataset/original//Metrics-Repo-2010/xerces/xerces-1.4.csv,588,429,261,0.443877551,3,144,114,0,147,114
